Arabic Word 	Gloss	Diacritized Reference
البك	Ilbak	بِك
لك	Lak	لَك
لك	Lugo	لُك
مق	Meg	مِق
ني	Ney	نَي
ني	Ní	نِي
سار	Sarh	سَار
شاو	Shaw	شَاو
آبا	Aba	آبَا
الست	Al-Sit	سِتّ
آمل	Amol	آمُل
آبا	Appa	آبَا
أوش	Auch	أَوْش
بم	Bam	بَم
بان	Ban	بَان
بيث	Beth	بِيث
بوش	Bosch	بُوش
بان	Bunn	بَان
بوش	Busch	بُوش
بوش	Bush	بُوش
كام	Cam	كَام
كار	Carr	كَار
كام	Cham	كَام
داي	Dai	دَاي
داي	Day	دَاي
ديب	Deeb	دِيب
ديب	Deep	دِيب
داي	Dey	دَاي
ديب	Dib	دِيب
الواس	Elvas	إِلْوَاس
فات	Fate	فَات
جين	Gene	جِين
جين	Gin	جِين
جين	Gine	جِين
هاي	Hai	هَاي
هاي	Hay	هَاي
أوش	Hoche	أَوْش
حور	Hur	حُور
جآي	JeA	جَآي
جين	Jean	جِين
جين	Jeane	جِين
جين	Jeanne	جِين
جين	Jin	جِين
كاج	Kaj	كَاج
كام	Kam	كَام
كخ	Koch	كُخ
لام	Lame	لَام
مار	Mar	مَار
ميد	Mead	مِيد
ميد	Meade	مِيد
أم	Mom	أُمّ
بان	Moringa	بَان
نام	Nam	نَام
أوش	Osh	أُوش
بان	Pan	بَان
بوش	Push	بُوش
رِيس	Reese	رِيس
رين	Reine	رِين
رين	Rennes	رِين
رين	Rin	رِين
روت	Root	رُوت
روت	Rott	رُوت
سار	Sar	سَار
تاي	Tay	تَاي
تيد	TED	تِيد
تيد	Ted	تِيد
تيد	Teide	تِيد
تاي	Ty	تَاي
أم	Umm	أُمّ
عور	Ur	عُور
ويق	Vieq	وِيق
ويد	Wade	وِيد
ور	Ware	وِر
وود	Wood	وُود
آبا	ABBA	آبَا
أدل	Adel	أَدِل
طعد	Agesander	طَعْد
عاي	Ai	عَاي
آجين	Ajin	آجِين
أقا	Akka	أَقَّا
العجم	Al-Ajam	عَجَم
العقق	Al-Aqaq	عَقَق
الفنخ	Al-Fankh	فَنْخ
الفرع	Al-Fara	فَرَع
القبو	Al-Qabu	قَبْو
القصف	Al-Qasf	قَصْف
ألف	Aleph	أَلِف
ألف	Alf	أَلْف
ألف	Alv	أَلْف
النخر	An-Nakhar	نَخَر
السبل	As-Siball	سِبَل
الطَّرف	Atarfe	طَرْف
بيلك	Belk	بِيلْك
بويس	Bowes	بُويْس
بويس	Boyce	بُويْس
إشتهارد	Eshtehard	إِشْتِهَارْد
درب	Darb	دَرْب
قلت	Dereiçi	قَلْت
الدقم	Duqm	دُقْم
إشتوريل	Estoril	إِشْتُورِيل
مصر	Egypt	مِصْر
فجر	Fajr	فَجْر
فلك	Falak	فَلَك
صقر	Falco	صَقْر
فلك	Falk	فَلْك
حمل	Farvardin	حَمَل
فشع	Fasha	فَشَع
فلت	Flat	فْلَت
حدا	Hada	حَدَا
حلا	Hala	حَلَا
هشم	HaShem	هَشِم
هبة	Heba	هِبَة
هرق	Heraq	هِرَق
هبة	Hiba	هِبَة
المجر	Hungary	مَجَر
جبا	Jabah	جَبَا
جين	Jane	جَيْن
جها	Jha	جَهَا
جفد	Jufad	جُفَد
خمر	Khamr	خَمْر
خرب	Khorab	خُرَب
لغز	Lagaz	لَغَز
الأسد	Leo	أَسَد
حمل	Load	حَمْل
مبح	Mabah	مَبَح
مدل	Madil	مَدِل
إدلسان	Idelsane	إِدِلْسَان
ميط	Maydh	مَيْط
مصر	Mesr	مِصْر
ميا	Mia	مِيَا
مكب	Mikab	مِكَب
ميا	Mýa	مِيَا
نعب	Na`ab	نَعَب
ندر	Nadr	نَدْر
نعض	Nu`d	نُعْض
أوس	Oss	أُوسّ
شعب	People	شَعْب
حور	Populus	حَوْر
بايك	Pyke	بَايْك
قنا	Qena	قِنَا
ريل	Rayl	رَيْل
صقر	Saker	صَقِر
صقر	Saqr	صَقْر
صايص	Sées	صَايْص
ستن	Setan	سِتَن
شعب	She'eb	شِعِب
سلاس	Sless	سْلَاس
طرف	Taraf	طَرَف
الظهر	Thahr	ظَهْر
ثيا	Thea	ثِيَا
ثيا	Theia	ثِيَا
التبت	Tibet	تِبِت
طرف	Tip	طَرَف
إضمين	Idmine	إِضْمِين
إديا	Edéa	إِدْيَا
إفارت	Evart	إِفَارْت
زئيف	Ze'ev	زِئِيف
إفريا	Ivrea	إِفْرِيَا
إهيا	Iheya	إِهِيَا
إهمج	Ehmej	إِهْمِج
العليم	Al-Alim	عَلِيم
العمود	Al-Amud	عَمُود
البلة	Al-Billah	بِلَّة
الغظاة	Al-Ghadhah	غَظَاة
الغيان	Al-Ghiyan	غِيَان
الحبيل	Al-Habil	حَبِيل
الحاجر	Al-Hajir	حَاجِر
الجيزة	Al-Jiza	جِيزَة
الجوار	Al-Juwar	جُوَار
إكسالمونس	Exelmans	إِكْسَالْمُونْس
الغارا	Algarra	أَلْغَارَّا
إلسبيث	Elsebeth	إِلْسِبِيث
ملاك	Angel	مَلَاك
آنثي	Anthe	آنْثِي
أبيس	Apis	أَبِيس
الردة	Ar-Raddah	رَدَّة
الرخي	Ar-Rakhi	رَخِيّ
أسين	Asin	أَسِين
أسين	Asín	أَسِين
اسور	Asur	أَسُور
إليسهايم	Illesheim	إِلِيسْهَايِم
الزعاب	Az-Zaab	زَعَاب
بادر	Baader	بَادِر
بارن	Baarn	بَارْن
بديع	Badí‘	بَدِيع
بديع	Badí‘	بَدِيع
بديع	Badiee	بَدِيع
بديع	Badiee	بَدِيع
بديع	Badīʻ	بَدِيع
بديع	Badīʻ	بَدِيع
بايك	Baek	بَايِك
باغز	Baggs	بَاغْز
إليزا	ELISA	إِلِيزَا
إليزا	Eliza	إِلِيزَا
إليزا	ELIZA	إِلِيزَا
إلبيديوس	Elpidius	إِلْبِيدِيُوس
إلغاتو	Elgato	إِلْغَاتُو
إلسيليموماب	Elsilimomab	إِلْسِيلِيمُومَاب
إلوداي	Elodie	إِلُودَاي
إلوس	Elos	إِلُوس
إمحوتب	Imhotep	إِمْحُوتِب
إمسيلكس	Emselex	إِمْسِيلِكْس
إنشوبينغ	Enköping	إِنْشُوبِينْغ
إنفيبكو	Envipco	إِنْفِيبْكُو
إنكيشوش	Inkishush	إِنْكِيشُوش
إنكريس	Increase	إِنْكْرِيس
إنتايت	Entiat	إِنْتَايِت
إنترلاكن	Interlaken	إِنْتَرْلَاكِن
بيغس	Beggs	بِيغْس
إريكسون	Erickson	إِرِيكْسُون
إريكسون	Ericson	إِرِيكْسُون
إريكسون	Ericsson	إِرِيكْسُون
إريكسون	Erikson	إِرِيكْسُون
إريتشي	Erice	إِرِيتْشِي
إرحالن	Irohalen	إِرْحَالِن
إسباستر	Ispaster	إِسْبَاسْتِر
إسفنداران	Esfandaran	إِسْفَنْدَارَان
بوناه	Boonah	بُونَاه
بونس	Bounce	بَوْنْس
إسكسي	Isseksi	إِسِكْسِي
إسكتلندا	Scotland	إِسْكُتْلَنْدَا
إتاسكا	Itasca	إِتَاسْكَا
البوغة	Bughah	بُوغَة
إتريك	Ettrick	إِتْرِيك
إثناتي	Iznate	إِثْنَاتِي
أبلاي	Aballay	أَبَلَاي
إيغيرويلا	Higueruela	إِيغِيرُويِلَا
شينون	Chinon	شِينُون
إيان	Ian	إِيَان
إيبيكيتا	Ipecaetá	إِيبِيكِيتَا
إيبونا	Epona	إِيبُونَا
إيداباشي	Iidabashi	إِيدَابَاشِي
إيدزفولد	Eidsvold	إِيدْزْفُولْد
إيفرقلو	Everglow	إِيفَرْقْلُو
أكوافيفا	Acquaviva	أَكُوَافِيفَا
ددن	Dadan	دَدَن
إيجل	Egil	إِيجِل
إيجلهام	Egglham	إِيجْلْهَام
إيكيرسدورف	Eckersdorf	إِيكِيرْسْدُورْف
إيكسان	Iksane	إِيكْسَان
إيكولاب	Ecolab	إِيكُولَاب
إيليا	Ilya	إِيلِيَا
إيلوري	Elloree	إِيلُورِي
دفن	Difan	دِفَن
الجريد	Djerid	جِرِيد
إينيني	Inini	إِينِينِي
الدقي	Dokki	دُقِّي
أكوريوس	Acoreus	أَكُورْيُوس
إيغيل	Eagle	إِيغِيل
ايبي	Ebbe	إِيبِي
ايغر	Eger	إِيغِر
إيريسوس	Ierissos	إِيرِيسُوس
إيرفاين	Irvine	إِيرْفَايْن
إيرمغارد	Irmgard	إِيرْمْغَارْد
إيرني	Ernie	إِيرْنِي
إيروينغتون	Irvington	إِيرْوِينْغْتُون
إيسا	Isa	إِيسَا
إيسه	Ise	إِيسَه
إيسميني	Ismene	إِيسْمِينِي
إيستاني	L’Estany	إِيسْتَانِي
إيستري	Eastry	إِيسْتْرِي
إيستبورن	Eastbourne	إِيسْتْبُورْن
إيتابيبوكا	Itapipoca	إِيتَابِيبُوكَا
إيتابيلا	Itabela	إِيتَابِيلَا
إيتربيك	Etterbeek	إِيتَرْبِيك
إيواو	Iwao	إِيوَاو
أشيل	Achille	أَشِيل
أباندا	Abanda	أَبَانْدَا
أبجد	Abjjad	أَبْجَد
أياني	Aiani	أَيَانِي
أبريس	Apries	أَبْرِيس
أبيجيل	Abigail	أَبِيجَيْل
أبينوخار	Abenójar	أَبِينُوخَار
أبيس	Abyss	أَبِيس
أبيساي	Apisai	أَبِيسَاي
أبديتا	Abdita	أَبْدِيتَا
أجسيكليز	Agasicles	أَجَسِيكْلِيز
أبليبي	Appleby	أَبْلِيبِي
الحبوس	Habous	حَبُوس
أبخازيا	Abkhazia	أَبْخَازِيَا
أبخورة	Abkhvoreh	أَبْخُورَة
أبوتكس	Apotex	أَبُوتِكْس
أدرنة	Edirne	أَدِرْنَة
أديلين	Adelin	أَدِيلِين
الخليل	Hebron	خَلِيل
أدفاغراف	Advagraf	أَدْفَاغْرَاف
هيلر	Heller	هِيلَر
أدغيل	Adghayl	أَدْغَيْل
أدما	Adma	أَدْمَا
أدراسمون	Adrasmon	أَدْرَاسْمُون
أدولف	Adolf	أَدُولْف
أدولف	Adolph	أَدُولْف
أدولف	Adolphe	أَدُولْف
أدولف	Audulf	أُدُولْف
أفنيون	Avignon	أَفِنْيُون
أفياري	Aviary	أَفْيَارِي
أفيلا	Avella	أَفِيلَا
أفيلا	Avilla	أَفِيلَا
شعال	Shaal	شَعَال
أفيرميس	Avermes	أَفِيرْمِيس
أفراح	Afrah	أَفْرَاح
أفراموفو	Avramovo	أَفْرَامُوفُو
أفراسياب	Afrasiab	أَفْرَاسِيَاب
شكيم	Shechem	شِكِيم
أفسو	Afsou	أَفْسُو
أغابوس	Agabus	أَغَابُوس
أغادا	Aghada	أَغَادَا
أغريبا	Agrippa	أَغْرِيبَا
خرة	Kherreh	خِرَّة
أغوتمان	Aghutman	أَغُوتْمَان
شنان	Anabasis	شَنَان
أهود	Ehud	أَهُود
شريف	Sharif	شَرِيف
أجدابيا	Ajdabiya	أَجْدَابِيَا
أجريل	Agrale	أَجْرِيل
كورش	Kourosh	كُورْش
كوروا	Kourou	كُورُوَا
شريف	Sherif	شِرِيف
أكليف	Aglif	أَكْلِيف
أكلينز	Acklins	أَكْلِينْز
أكنول	Aknoul	أَكْنُول
أكرسان	Akersane	أَكِرْسَان
أكسل	Aksel	أَكْسِل
أكسل	Axel	أَكْسِل
شواز	Shavaz	شَوَاز
ألشتر	Aleshtar	أَلِشْتَر
شنان	Shinan	شِنَان
أليكسيفا	Alexeyeva	أَلِيكْسِيفَا
أليزيو	Alezio	أَلِيزِيُو
ألبال	Albal	أَلْبَال
ألبيمارل	Albemarle	أَلْبِيمَارْل
ألبيرا	Alpera	أَلْبِيرَا
ألبيرونا	Alberona	أَلْبِيرُونَا
ألبيون	Albion	أَلْبِيُون
أهوارك	Ahvarak	أَهْوَارَك
بانو	Bannu	بَانُو
باري	Parry	بَارِي
بارن	PARN	بَارْن
بجيم	Pajim	بَجِيم
بيكو	Peko	بِيكُو
مجيك	Mijek	مِجِيك
بيكو	Piku	بِيكُو
بيرآخ	Perach	بِيرآخ
ألتود	Altud	أَلْتُود
ألتورف	Altorf	أَلْتُورْف
بتاح	Ptah	بْتَاح
أمادورا	Amadora	أَمَادُورَا
أمافيدا	Amavida	أَمَافِيدَا
أمالفي	Amalfi	أَمَالْفِي
أمانيزلو	Amanislo	أَمَانِيزْلُو
أماندا	Amanda	أَمَانْدَا
بوبر	Popper	بُوبَر
بونس	Ponce	بُونْس
أمشير	Meshir	أَمْشِير
أمشيتكا	Amchitka	أَمْشِيتْكَا
أمبانا	Ampana	أَمْبَانَا
أمغرة	Amghara	أَمْغَرَة
أناباي	Anabay	أَنَابَاي
أنامق	Anamoq	أَنَامُق
أناندال	Annandale	أَنَانْدَال
أناتول	Anatole	أَنَاتُول
أنايا	Anaya	أَنَايَا
بونس	Pons	بُونْس
ألتشيفسك	Alchevsk	أَلْتْشِيفِسْك
عجاج	Agag	عَجَاج
فوغو	Fogo	فُوغُو
فوغو	Fugu	فُوغُو
غاغو	Gago	غَاغُو
أيتوليكو	Aitoliko	أَيْتُولِيكُو
غورد	Gord	غُورْد
والقاضي	Oualqadi	وَالْقَاضِي
هاغن	Hagen	هَاغِن
هاكو	Haku	هَاكُو
هاسل	Hassell	هَاسِل
أيتوتاكي	Aitutaki	أَيْتُوتَاكِي
أخازير	Akhazir	أَخَازِير
ألبونس	Albons	أَلْبُونْس
أنتيروب	ANTIROBE	أَنْتِيرُوب
حينة	Hinah	حِينَة
ألدرشوت	Aldershot	أَلْدَرْشُوت
هونغ	Kong	هُونْغ
بيخا	Peja	بِيخَا
جواش	Javash	جَوَاش
ألدخيسل	Aldgisl	أَلْدْخِيسِل
جخيش	Jekhish	جِخِيش
ألغينيا	Algueña	أَلْغِينْيَا
جبة	Jubbah	جُبَّة
ألديرس	Allders	أَلْدِيرْس
جودا	Judah	جُودَا
ألتسشورن	Aletschhorn	أَلِتْسْشُورْن
كريب	KREEP	كْرِيب
أربط	Arbat	أَرْبَط
أردل	Ardal	أَرْدَل
أرفارا	Arfara	أَرْفَارَا
أرفير	Arvier	أَرْفِير
أرغين	Arguin	أَرْغِين
أرجك	Arjak	أَرْجَك
أركانة	Argana	أَرْكَانَة
أركم	Arkham	أَرْكَم
أركيل	Arkell	أَرْكِيل
أركور	Arcore	أَرْكُور
ليتو	Leto	لِيتُو
ليتو	Lito	لِيتُو
لولو	Lulu	لُولُو
مايو	Maio	مَايُو
مايو	May	مَايُو
مايو	Mayo	مَايُو
مداي	Madai	مَدَاي
مجيد	Majid	مَجِيد
ملاك	Malak	مَلَاك
أولكيبوب	Allkpop	أُولْكِيبُوب
شعب	Sha'ab	شَعَب
ألمالي	Almaly	أَلْمَالِي
ألويسي	Aloisi	أَلُوِيسِي
أمندي	Amandi	أَمَنْدِي
مناب	Munab	مُنَاب
عمرحوت	Amrhut	عُمْرَحُوت
عمالقة	Amalekites	عَمَالِقَة
ناسو	Naso	نَاسُو
ناسو	Nasu	نَاسُو
سيلاو	Silao	سِيلَاو
نقير	Naqir	نَقِير
نراق	Naraq	نَرَاق
عميعاد	Ami'ad	عَمِيعَاد
عمينداف	Aminadav	عَمِينْدَاف
ريغا	Riga	رِيغَا
رينز	Rhens	رِينْز
أيابيل	Ayapel	أَيَابِيل
ريسي	Reese	رِيسِي
ستن	Sten	سْتِن
أيسك	Ayask	أَيَسْك
أيلين	Aileen	أَيْلِين
أينسورث	Ainsworth	أَيْنْسُورْث
ريثل	Rethel	رِيثِل
صافي	Safi	صَافِي
أنوهاك	Anahuac	أَنُوهَاك
عمروس	Amrous	عَمْرُوس
تافت	Taft	تَافْت
طلاس	Talas	طَلَاس
تليه	Telih	تِلِيه
تريش	Terish	تِرِيش
تيكس	Tex	تِيكْس
تتا	Thatta	تَتَّا
تهيل	Theale	تِهِيل
ثيان	Thiane	ثِيَان
ثولي	Thule	ثُولِي
تيكس	Tix	تِيكْس
تيزج	Tizej	تِيزِج
تومي	Tomie	تُومِي
تومي	Tommi	تُومِي
تومي	Tomy	تُومِي
توبين	Töpen	تُوبِين
طولش	Towlash	طُولَش
تريل	Trail	تْرِيل
توتل	Tuttle	تُوتِل
يوديل	Udell	يُودِيل
بارو	Utqiagvik	بَارُو
وير	Viyar	وِير
فآنغ	Wang	فَآنْغ
واساب	Wassup	وَاسَاب
فينر	Weener	فِينَر
ويلن	Willen	وِيلْن
رايت	Wright	رَايْت
ووهو	Wuhu	وُوهُو
ياكلا	Yala	يَاكْلَا
يوني	Yuni	يُونِي
ذاكر	Zaker	ذَاكِر
زاراي	Zaraï	زَارَاي
زئيف	Zeev	زِئِيف
زينك	Zink	زِينْك
زينر	Zinner	زِينَر
شيوان	Ziyuan	شِيوَان
الست	Aalst	أَلْسْت
أنغلسي	Anglesey	أَنْغِلْسِي
أبييف	Abiyev	أَبِييِف
أنكوريج	Anchorage	أَنْكُورِيج
سبير	Spier	سْبِير
سكار	Scar	سْكَار
سميث	Smith	سْمِيث
سنيد	Snead	سْنِيد
أندالجالا	Andalgalá	أَنْدَالْجَالَا
سوفة	Souve	سُوفَة
العجمة	Al-Ajmah	عَجْمَة
الفرضة	Al-Fardah	فَرْضَة
الفرذخ	Al-Fardthakh	فَرْذَخ
الفرضة	Al-Furdah	فُرْضَة
الجبار	Al-Jabbar	جَبَّار
الجحلة	Al-Jahlah	جَحْلَة
الخشبة	Al-Khashbah	خَشْبَة
الشماط	Al-Shammat	شَمَّاط
السخنة	Al-Sukhnah	سُخْنَة
التبني	Al-Tabni	تَبْنِي
سوجو	Suzhou	سُوجُو
أندالوسيا	Andalusia	أَنْدَالُوسِيَا
سوسة	Sousse	سُوسَة
أقصي	Aqsa	أَقْصِي
الرقيد	Ar-Riqayyid	رِقَيِّد
سوسة	Susa	سُوسَة
أوبرتال	Oberthal	أُوبَرْتَال
أوبرين	O'Brien	أُوبَرْيَن
أوبيليتش	Obilić	أُوبِيلِيتْش
أوبلي	Ubly	أُوبْلِي
أركوي	Arki	أَرْكُوِي
أنفيلا	Anfila	أَنْفِيلَا
الشكله	Ash-Shaklah	شَكْلَه
أنغرغان	Angergan	أَنْغَرْغَان
اصلة	Asleh	أَصْلَة
أودل	Odell	أُودِل
أنيلاكو	Anillaco	أَنِيلَاكُو
أنغوليم	Angoulême	أَنْغُولِيم
أرامايونا	Aramaio	أَرَامَايُونَا
أياني	Ayane	أَيَانِي
أنجالي	Anjali	أَنْجَالِي
خشاش	Khishash	خِشَاش
ازوا	Azua	أَزُوَا
خوفو	Khufu	خُوفُو
أنسغار	Ansgar	أَنْسْغَار
أتيو	Atiu	أَتِيُو
أوعل	Aw'al	أَوْعَل
أنثيميوس	Anthemius	أَنْثِيمِيُوس
عربسيو	Arabsiyo	عَرَبْسِيُو
عرافيت	Arafit	عَرَافِيت
أوغوس	Ogus	أُوغُوس
أوماك	Omak	أُومَاك
أوريم	Orem	أُورِيم
أوريم	Ourém	أُورِيم
آليجي	Alcîya	آلِيجِي
البياض	Bayyad	بَيَّاض
أراغورن	Aragorn	أَرَاغُورْن
أرندت	Arendt	أَرِنْدْت
شحمة	Shahma	شَحْمَة
أراباهو	Arapaho	أَرَابَاهُو
شطحة	Shathah	شَطْحَة
أرابيوشا	Arapuša	أَرَابِيُوشَا
شلنك	Shelnak	شِلْنَك
عرباوة	Arbaoua	عَرْبَاوَة
أرباتان	Arbatan	أَرْبَاتَان
أساكو	ASACO	أَسَاكُو
أسانو	Asano	أَسَانُو
أيرومورا	Arimura	أَيْرُومُورَا
بعشا	Baasha	بَعْشَا
بهلة	Bahleh	بَهْلَة
أرسيليك	Arçelik	أَرْسِيلِيك
كونن	Conan	كُونَن
بسام	Bassam	بَسَّام
أرتشينا	Archena	أَرْتْشِينَا
بنلد	Benld	بِنْلْد
بسوة	Pasveh	بِسْوَة
أركوي	Arkoe	أَرْكُوِي
بيسيك	BASIC	بِيسِيك
كروفا	Crova	كْرُوفَا
بيسيك	Pisek	بِيسِيك
أرنزفيل	Arenzville	أَرِنْزْفِيل
بيتيت	Petit	بِيتِيت
أوسثوس	Osthouse	أُوسْثُوس
أوطاخي	Eutyches	أُوطَاخِي
أرَيُولُس	Arraiolos	أَرَيُولُس
أوثو	Otho	أُوثُو
بوراي	Buray	بُورَاي
بوخوف	Púchov	بُوخُوف
بوزوم	Bozoum	بُوزُوم
داديخ	Dadikh	دَادِيخ
داهود	Dahod	دَاهُود
دالاس	Dallas	دَالَاس
داروك	DarUk	دَارُوك
دايان	Dayan	دَايَان
عروسان	Arusan	عَرُوسَان
دوكة	Dawkah	دَوْكَة
آلفلد	Alfeld	آلْفِلْد
ديغوس	Digos	دِيغُوس
آرغريتش	Argerich	آرْغْرِيتْش
آسكوي	Askøy	آسْكُوي
آستارا	Astara	آسْتَارَا
آتنغل	Attingal	آتِنْغَل
السخنة	El-Sokhna	سُخْنَة
آتشال	Achall	آتْشَال
آتشاركوت	Acharkut	آتْشَارْكُوت
آخساخلار	Akhsakhlar	آخْسَاخْلَار
آيجير	Aegir	آيْجِير
شابوص	Shabus	شَابُوص
شادمهر	Shadmehr	شَادْمِهْر
شاغر	Shaghir	شَاغِر
ديمان	Diman	دِيمَان
فريير	Freer	فْرِييِر
دينير	Denner	دِينِير
دودار	Dúdar	دُودَار
دوفور	Dufour	دُوفُور
دوفور	Dufur	دُوفُور
أرماه	Armagh	أَرْمَاه
أسبري	Asbury	أَسْبُرِي
دونيل	Donnell	دُونِيل
دونيل	Dunnell	دُونِيل
علام	Alam	عَلَام
علام	Allam	عَلَّام
الحبيل	Habil	حَبِيل
عقرة	Akre	عَقْرَة
أرطميدورس	Artemidoros	أَرْطَمِيدُورُس
فالوز	Fallows	فَالُوز
فاسيت	Fassett	فَاسِيت
فردن	Verden	فِرْدِن
فيديس	Faedis	فِيدِيس
فيديس	Vides	فِيدِيس
عاشيت	Ashayet	عَاشَيْت
فيليم	Velim	فِيلِيم
فيريث	Férez	فِيرِيث
فُدجَة	Foggia	فُدْجَة
فوكام	Fawkham	فُوكَام
شريفلو	Shariflu	شَرِيفْلُو
احدى	Ihda	إِحْدَى
أتكيوسوك	Atqasuk	أَتْكْيُوسُوك
غالوس	Gallus	غَالُوس
ايرين	Irin	إِيرِين
أتيلا	Attila	أَتِيلَا
غيلون	Gilon	غِيلُون
غردي	Gordi	غُرْدِي
حشنة	Hasheneh	حَشْنَة
هاكو	Hakko	هَاكُّو
هاواي	Hawaï	هَاوَاي
هاواي	Hawaii	هَاوَاي
حبحب	Habhab	حَبْحَب
أتينغ	Atting	أَتِينْغ
أسوبوس	Asopos	أَسُوبُوس
شيشاوان	Shishavan	شِيشَاوَان
أتيليتا	Ateleta	أَتِيلِيتَا
هيجين	Hejin	هِيجِين
هوهوت	Hohhot	هُوهُوت
شيفر	Schafer	شِيفَر
شيفر	Schäfer	شِيفَر
أثاماس	Athamas	أَثَامَاس
أثاناريك	Athanaric	أَثَانَارِيك
شيلان	Chelan	شِيلَان
شيلان	Shilan	شِيلَان
شيمورا	Shimura	شِيمُورَا
شينافان	Shenavan	شِينَافَان
شينيفيل	Chénéville	شِينِيفِيل
شينينغ	Xining	شِينِينْغ
كونيغ	König	كُونِيغ
أوفلانس	Auflance	أُوفْلَانْس
جمصة	Gamasa	جَمَصَة
أولا	Aulla	أَوُلَّا
جيهان	Jehan	جِيهَان
اللجون	Lajjun	لَجُّون
جيهان	Jihan	جِيهَان
شيصة	Shisah	شِيصَة
جيمين	Jimin	جِيمِين
شبونهايم	Sponheim	شْبُونْهَايِم
شفاندورف	Schwandorf	شْفَانْدُورْف
جيسات	Gessate	جِيسَات
جنتر	Gunter	جُنْتَر
جوناس	Jonas	جُونَاس
جوقان	Juqan	جُوقَان
شبيطة	Shbita	شْبَيْطَة
شحمة	Shuhmah	شُحْمَة
شمارخ	Shamarikh	شَمَارِخ
شقرة	Shuqrah	شُقْرَة
شريط	Shurayt	شُرَيْط
أورياريا	Auriaria	أُورِيَارِيَا
أرورا	Aurora	أُرُورَا
أواجيق	Avajiq	أَوَاجِيق
شولان	Shulan	شُولَان
شولتز	Shultz	شُولْتْز
أفينتجورا	Aventura	أَفِينْتُجُورَا
كودن	Cowden	كَوْدِن
شوتس	Schütz	شُوتْس
المطلة	Matleh	مَطْلَة
ماولا	Maula	مَاوْلَا
باباغير	Babagir	بَابَاغِير
بابنا	Băbana	بَابَنَا
أفريلي	Avrilly	أَفْرِيلِي
عوالي	Awali	عَوَالِي
عيان	Ayan	عَيَان
عياصره	Ayasrah	عَيَاصْرَه
بادين	Paden	بَادِين
بافو	Paavo	بَافُو
بافو	Pavo	بَافُو
مندع	Minda	مِنْدَع
باغين	Baghin	بَاغِين
باهتة	Bahtah	بَاهْتَة
باجو	Bago	بَاجُو
باجو	Paju	بَاجُو
باكي	Becky	بَاكِي
باكي	Paki	بَاكِي
أيطن	Aydın	أَيْطَن
مواري	Murray	مُوَارِي
أزادبر	Azadbar	أَزَادْبَر
بالح	Balih	بَالِح
بالد	Baled	بَالِد
أزراح	Azarah	أَزَرَاح
أزيبين	Azepine	أَزِيبِين
بالتسي	Bălți	بَالْتْسِي
لبوة	Labwah	لَبْوَة
ناسو	Nassau	نَاسُو
بابنا	Babna	بَابْنَا
بانف	Banff	بَانْف
بدولي	Baduli	بَدُولِي
نايكي	Nike	نَايْكِي
باينفيل	Bainville	بَايِنْفِيل
مافيي	Maffei	مَافِيي
بحصاصة	Bahsassa	بَحْصَاصَة
بجيلة	Bajila	بَجِيلَة
بلهدان	Balahdan	بَلَهْدَان
الجبار	Orion	جَبَّار
أوستي	Ostindustrie	أُوسْتِي
بالانجيرو	Balangero	بَالَانْجِيرُو
بانكس	Banks	بَانْكْس
باري	Bari	بَارِي
باري	Barry	بَارِي
بانلونغ	Banlung	بَانْلُونْغ
باناش	Bannach	بَانَاش
بعقوبة	Baqubah	بَعْقُوبَة
برنقور	Baranqur	بَرَنْقُور
باربر	Barber	بَارْبَر
بيتون	Petone	بِيتُون
باردي	Bardi	بَارْدِي
باربرو	Barbro	بَارْبْرُو
بارينغ	Baring	بَارِينْغ
بارك	PARC	بَارْك
بارك	Park	بَارْك
بيرد	Baird	بِيرْد
بارلو	Barlow	بَارْلُو
مسحة	Mas-ha	مَسْحَة
بلاط	Ballat	بَلَّاط
برميون	Barmeyun	بَرْمِيُون
باري	Bare	بَارِي
الرتبة	Ratba	رَتْبَة
باسينيانا	Bassignana	بَاسِينْيَانَا
بارمظة	Barmazh	بَارْمَظَة
باتيرنو	Baterno	بَاتِيرْنُو
بوتسفيورد	Båtsfjord	بُوتْسْفْيُورْد
بارو	Bar	بَارُو
بارو	Baro	بَارُو
ريزي	Rezé	رِيزَي
بارو	Barrow	بَارُو
بارو	Paro	بَارُو
باروس	Barros	بَارُوس
باروس	Paros	بَارُوس
باروس	Parus	بَارُوس
باتوان	Batuan	بَاتُوَان
باومهولدر	Baumholder	بَاوْمْهُولْدَر
بارالي	Barrali	بَارَالِي
بايوجان	Bayugan	بَايُوجَان
باري	Barre	بَارِي
باري	Barrie	بَارِي
بينهم	Beenham	بِينْهَم
بيكيلي	Bekily	بِيكِيلِي
باوج	Bavaj	بَاوَج
بيسهنتر	Basshunter	بِيسْهَنْتَر
نوجان	Nowjan	نُوجَان
شفايش	Schweich	شْفَايِش
بلفاع	Belfaa	بِلْفَاع
بلفاست	Belfast	بِلْفَاسْت
راجان	Razhan	رَاجَان
بلترام	Beltrame	بِلْتْرَام
ريدان	Ridan	رِيدَان
ريدان	Ridane	رِيدَان
بلفيليو	Belveglio	بَلْفِيلْيُو
بيناكوفاك	Benakovac	بِينَاكُوفَاك
بنيدورم	Benidorm	بِنِيدُورْم
رودين	Rhoden	رُودِين
رودين	Rodin	رُودِين
رودين	Ruden	رُودِين
رودين	Rudin	رُودِين
شتويك	Shotwick	شُتْوِيك
باتساني	Bățani	بَاتْسَانِي
بنسون	Benson	بِنْسُون
أوزنغول	Uzungöl	أُوزُنْغُول
شاغنون	Chagnon	شَاغْنُون
بايسنقر	Baysonqor	بَايْسُنْقُر
سِكِم	Sikkim	سِكِم
شاكتي	Shakti	شَاكْتِي
سيناي	Sinnai	سِينَاي
بنتلي	Bentley	بِنْتْلِي
الصمعة	Somâa	صَمْعَة
شاتورا	Shatura	شَاتُورَا
شاختاو	Shakhtau	شَاخْتَاو
بشتفين	Bchetfine	بْشِتَفِين
بيرغستروم	Bergström	بِيرْغْسْتْرُوم
شازند	Shazand	شَازَنْد
شفتلارن	Schäftlarn	شَفْتْلَارْن
شهدادبور	Shahdadpur	شَهْدَادْبُور
طاران	Taran	طَارَان
طاران	Tarane	طَارَان
شهدادكوت	Shahdadkot	شَهْدَادْكُوت
بيتيفيل	Beattyville	بِيتِيفِيل
شمشون	Samson	شَمْشُون
بلعربي	Belarbi	بَلْعَرْبِي
بنسنفيل	Bensenville	بِنْسِنْفِيل
برلين	Berlin	بِرْلِين
وابول	Wapol	وَابُول
شرقاوة	Charqaoua	شَرْقَاوَة
بصير	Basir	بَصِير
بصير	Bassir	بَصِير
بسوس	Bsous	بْسُوس
وزنة	Vazneh	وَزْنَة
شيبون	Shaybun	شَيْبُون
الوحدة	Unity	وَحْدَة
بيرميكورت	Bermicourt	بِيرْمِيكُورْت
وورين	Warren	وُورِين
شينوت	Shaynut	شَيْنُوت
شلاتو	Scillato	شِلَاتُو
يانان	Yan'an	يَانَان
بيريفيل	Berryville	بِيرِيفِيل
فييشي	Vische	فِيِيشِي
شندأباد	Shendabad	شِنْدَأَبَاد
الوراق	Warraq	وَرَّاق
ييرين	Yerin	يِيرِين
يونوت	Ionuț	يُونُوت
زاخاس	Tzachas	زَاخَاس
زهرا	Zahra	زَهْرَا
بلاط	Balat	بَلَاط
بلاط	Blat	بْلَاط
أبهول	Uphall	أَبْهُول
ألفان	Alvan	أَلْفَان
أنجيل	Angèle	أَنْجِيل
الزريزر	Zrizer	زْرِيزِر
العديمة	Adimeh	عَدِيمَة
ادكان	Adkan	أَدْكَان
أنسان	Ansan	أَنْسَان
أنتيب	Antibes	أَنْتِيب
أنزان	Anzan	أَنْزَان
بنزوه	Benzouh	بِنْزُوه
بيرتن	Bertin	بِيرْتِن
بنين	Benin	بِنِين
باركشير	Berkshire	بَارْكْشِير
احشي	Ahshi	أَحْشِيّ
بيتينا	Bettina	بِيتِينَا
بيويل	Beuil	بِيُويِل
شيرتز	Schertz	شِيرْتْز
العوضي	Al-Awadi	عَوَضِيّ
البشائر	Al-Bashair	بَشَائِر
البدايع	Al-Bidayu	بِدَايِع
الجرداء	Al-Jarda	جَرْدَاء
الخبين	Al-Khabbayn	خَبَّيْن
المعشور	Al-Ma`Shur	مَعْشُور
المدينة	Al-Madinah	مَدِينَة
المنارة	Al-Manara	مَنَارَة
المنسي	Al-Mansi	مَنْسِيّ
المرجام	Al-Murjam	مُرْجَام
النعمان	Al-Nu'man	نُعْمَان
القرارة	Al-Qarara	قَرَارَة
الوارية	Al-Waryah	وَارْيَة
بتحلين	Bhanine	بَتْحَلِين
شليهدورف	Schlehdorf	شْلِيهْدُورْف
المدينة	Almadina	مَدِينَة
ألطون	Alton	أَلْطُون
بيكورو	Bikoro	بِيكُورُو
شتاتبرغن	Stadtbergen	شْتَاتْبَرْغِن
شترالزوند	Stralsund	شْتْرَالْزُونْد
النعمان	An-Naman	نَعْمَان
بيلاسوار	Bilasuvar	بِيلَاسُوَار
بيلوهيرسك	Bilohirsk	بِيلُوهِيرْسْك
أنمزي	Anemzi	أَنِمْزِي
بيركا	Birka	بِيرْكَا
بيرزيت	Birzeit	بِيرْزِيت
بيسكوتر	Biscúter	بِيسْكُوتِر
بيتاما	Bitama	بِيتَامَا
بيولكاتي	Biolcati	بِيُولْكَاتِي
آكينو	Aquino	أَكِينُو
بيراتوري	Biratori	بِيرَاتُورِي
ارداق	Ardak	أَرْدَاق
ارفاق	Arfaq	أَرْفَاق
بنزرت	Bizerte	بِنْزَرْت
بوردمان	Boardman	بُورْدْمَان
بودنفيردر	Bodenwerder	بُودِنْفِيرْدَر
بوغراد	Bograd	بُوغْرَاد
أرووود	Arrowwood	أَرُووُود
بيكو	Beko	بِيكُو
بيكو	Biko	بِيكُو
ارزوم	Arzum	أَرْزُوم
بيكو	Biku	بِيكُو
بمهريه	Bmohray	بَمُهْرِيه
الشريخة	Ash-Shiraykhah	شَرِيخَة
بولتانيا	Boltaña	بُولْتَانْيَا
آشفيل	Ashville	أَشْفِيل
اسليت	Aslit	أَسْلِيت
استون	Astun	أَسْتُون
اسورا	Asura	أَسُورَا
أثنس	Athens	أَثِنْس
شومافا	Böhmerwald	شُومَافَا
بوناريس	Bonares	بُونَارِيس
بونسيل	Boncelles	بُونْسِيل
بونيفاي	Bonifay	بُونِيفَاي
باورز	Bowers	بَاوَرْز
باورز	Powers	بَاوَرْز
بازغة	Bazegeh	بَازِغَة
اريدو	Avondale	أَرِيدُو
بونازا	Bonanza	بُونَازَا
بلاطة	Boullata	بُلَّاطَة
بونرار	Bounrar	بُونْرَار
بَريدِس	Paredes	بَرِيدِس
بركاب	Parkab	بَرْكَاب
بزتشلو	Bozchalu	بُزْتْشَلُو
بونينال	Boninal	بُونِينَال
بوردالبا	Bordalba	بُورْدَالْبَا
بيرد	Beard	بِيرْد
بيرد	Byrd	بِيرْد
بايرام	Bayram	بَايْرَام
بورتيلورن	Bortelhorn	بُورْتِيلُورْن
بورزيا	Borzia	بُورْزِيَا
بورزيا	Borzya	بُورْزِيَا
بوسكوفيتش	Boskovic	بُوسْكُوفِيتْش
بوعنداس	Bouandas	بُوعَنْدَاس
بوهارون	Bouharoun	بُوهَارُون
بردك	Braddock	بْرَدُك
بارمن	Barmen	بَارْمِن
بارستو	Barstow	بَارْسْتُو
بارسونز	Parsons	بَارْسُونْز
باسالت	Basalt	بَاسَالْت
بزوان	Bezvan	بِزْوَان
برهامبور	Brahmapur	بَرُهَامْبُور
بوزنيقة	Bouznika	بُوزْنِيقَة
بورسفيل	Bowersville	بَوَرْسْفِيل
برسوانا	Breswana	بْرِسْوَانَا
بوتسولي	Bozzole	بُوتْسُولِي
برجيتسي	Brežice	بْرِجِيتْسِي
برامويل	Bramwell	بْرَامْوِيل
بيتون	Beeton	بِيتُون
بيتون	Bethune	بِيتُون
بيتون	Peotone	بِيتُون
بيتون	Peyton	بِيتُون
بريركرست	Briercrest	بْرِيَرْكْرِسْت
بريندلي	Brindley	بْرِينْدْلِي
بوسنة	Bosna	بُوسْنَة
البطانة	Butana	بُطَانَة
برومن	Brummen	بْرُومِن
بريفيو	Brivio	بْرِيفْيُو
كتمر	Catmore	كَتْمُر
سينجيو	Cengio	سِينْجِيُو
بيتون	Boyton	بُيْتُون
داجنة	Dajinah	دَاجِنَة
تشمة	Chammeh	تْشَمَّة
براونس	Browns	بْرَاوْنْس
بروشيد	Bruschied	بْرُوشِيد
بلوتو	Bluto	بْلُوتُو
برفينيتسا	Brvenica	بْرْفِينِيتْسَا
بروشغورن	Bruschghorn	بْرُوشْغُورْن
كومبيس	Combes	كُومْبِيس
جاموس	Bubalus	جَامُوس
بومهن	Bumahen	بُومَهَن
كامارينياس	Camariñas	كَامَارِينْيَاس
بلانسكو	Blansko	بْلَانْسْكُو
كاميلو	Camillo	كَامِيلُّو
بليبل	Blaybel	بْلَيْبِل
كارابانتس	Carabantes	كَارَابَانْتِس
كروويل	Crowell	كْرُووِيل
بوبيكون	Bubikon	بُوبِيكُون
بلوفر	Plover	بْلُوفِر
بوكانان	Buchanan	بُوكَانَان
بوكسبورت	Bucksport	بُوكْسْبُورْت
بوجاري	Bujari	بُوجَارِي
عريقة	Al-Ariqah	عَرِيقَة
بوجراش	Bujerash	بُوجِرَاش
كركميش	Carchemish	كَرْكِمِيش
بوربانك	Burbank	بُورْبَانْك
شيفر	Carinaria	شَيْفَر
دزلوخ	Desloch	دِزْلُوخ
بيرتن	Burton	بِيرْتِن
بوروندي	Burundi	بُورُونْدِي
كابيديلو	Cabedelo	كَابِيدِيلُو
كاثين	Cacín	كَاثِين
كاديه	Cadet	كَادِيه
كالابارزون	Calabarzon	كَالَابَارْزُون
بوبر	Bóbr	بُوبْر
كاليب	Caleb	كَالِيب
بودن	Boden	بُودِن
إيلغين	Elgin	إِيلْغِين
بودن	Bowden	بُودِن
كالينيشت	Călinești	كَالِينِيشْت
غياضة	Ghiyadah	غِيَاضَة
بودن	Budna	بُودْن
كالواي	Callaway	كَالُوَاي
غُمارة	Gómara	غُمَارَة
بوغو	Bogo	بُوغُو
بحمدون	Bhamdoun	بْحَمْدُون
هادية	Hadia	هَادِيَة
بجفاص	Bijfas	بِجْفَاص
بلاغدون	Blagdon	بْلَاغْدُون
بلاجيفيتش	Blažević	بْلَاجِيفِيتْش
بلاكمان	Blackman	بْلَاكْمَان
بلاكمور	Blackmore	بْلَاكْمُور
حمدان	Hamdan	حَمْدَان
بلانكو	Blanco	بْلَانْكُو
فيست	Fuest	فِيسْت
كالبورنيا	Calpurnia	كَالْبُورْنِيَا
بليشكوتا	Pleșcuța	بْلِيشْكُوتَا
بليلو	Blello	بْلِيلُو
هوانغ	Huang	هُوَانْغ
بليسد	Blessd	بْلِيسْد
كالفيغنانو	Calvignano	كَالْفِيغْنَانُو
كامارغو	Camargo	كَامَارْغُو
كارالكوفا	Carralcova	كَارَالْكُوفَا
كاربورو	Carrboro	كَارْبُورُو
جربان	Jurban	جُرْبَان
كاميلو	Camilo	كَامِيلُو
قايدو	Guido	قَايْدُو
القيطنة	Guittena	قِيطَنَة
كامبيرت	Campert	كَامْبِيرْت
كنداير	Canadair	كَنَدَايِر
كابيو	Capio	كَابِيُو
كارثي	Carthy	كَارْثِي
هايباخ	Haibach	هَايْبَاخ
كاراجليو	Caraglio	كَارَاجْلِيُو
كاتويرا	Catoira	كَاتُوِيرَا
كارينيون	Carignan	كَارِينْيُون
كافاتوري	Cavatore	كَافَاتُورِي
بترين	Petřín	بِتْرِين
بتروسا	PetroSA	بِتْرُوسَا
هاريلس	Harrells	هَارِيلْس
هاريتا	Harrietta	هَارِيتَّا
بيشكوف	Peshkov	بِيشْكُوف
بياقوت	Byaqout	بِيَاقُوت
بيرد	Bird	بِيَرْد
بيدارا	Pedara	بِيدَارَا
كارلوس	Carlos	كَارْلُوس
بيكنز	Pickens	بِيكِنْز
هولدين	Holden	هُولْدِين
كارلسون	Carlson	كَارْلْسُون
كارلسون	Carlsson	كَارْلْسُون
كارميليتا	Carmelita	كَارْمِيلِيتَا
شانارال	Chañaral	شَانَارَال
آيبيثا	Ibiza	آيْبِيثَا
كارونيا	Caronia	كَارُونِيَا
شنتوف	Chentouf	شِنْتُوف
شيركوس	Chercos	شِيرْكُوس
جايبور	Jaipur	جَايْبُور
كاروسو	Caruso	كَارُوسُو
كاسبر	Casper	كَاسْبَر
كاساداغا	Cassadaga	كَاسَادَاغَا
كاسيودوروس	Cassiodorus	كَاسِيُودُورُوس
شايان	Cheyenne	شَايَان
كاسيوس	Cassius	كَاسِيُوس
كاستيلار	Castelar	كَاسْتِيلَار
كاستيلار	Castellar	كَاسْتِيلَار
شايان	Cheyennes	شَايَان
جكوال	Chakwal	جَكْوَال
شيررني	Chiroroni	شِيرُرُنِي
الكرامة	Karameh	كَرَامَة
جمجمال	Chamchamal	جَمَجْمَال
كيفاسو	Chivasso	كِيفَاسُو
كلويه	Chloé	كْلُوِيه
القصدير	Kasdir	قَصْدِير
شربة	Chrabba	شْرَبَة
كريستي	Christi	كْرِيسْتِي
كريستيانا	Christiana	كِرِيسْتِيَانَا
كريستي	Christie	كْرِيسْتِي
كئتا	Keita	كِئْتَا
كريستي	Christy	كْرِيسْتِي
شونشيون	Chuncheon	شُونْشِيُون
خميسي	Khamasi	خَمَيْسِي
شُريانة	Churriana	شُرِيَانَة
الخضارة	Khedara	خِضَارَة
معغان	Ma'agan	مَعْغَان
كوديجيو	Codegua	كُودِيجْيُو
كودجولا	Coggiola	كُودْجُولَا
كوليسفيل	Colesville	كُولِيسْفِيل
كوليجدال	Collegedale	كُولِيجْدَال
كوليجيوفي	Collegiove	كُولِيجْيُوفِي
كومولا	Coloma	كُومُولَا
بلايسانس	Plaisance	بْلَايْسَانْس
كونن	Kühnen	كُونِن
بلومبرغ	Blumberg	بْلُومْبِرْغ
دافي	Davey	دَافِي
دافي	Davy	دَافِي
بلوتو	Blotto	بْلُوتُو
كولترين	Coltrane	كُولْتْرِين
لاوتون	Lawton	لَاوْتُون
كونكريت	Concrete	كُونْكْرِيت
كونفريسا	Confresa	كُونْفْرِيسَا
كونيف	Conniff	كُونِيف
مولدن	Maulden	مَوْلْدِن
دالي	Dale	دَالِي
دالي	Dali	دَالِي
دالي	Daly	دَالِي
كونسي	Consell	كُونْسِي
كونست	Consett	كُونْسِت
المرارة	M'Rara	مَرَارَة
كوريا	Correa	كُورِّيَا
كوريا	Correia	كُورِّيَا
كوسويندا	Cosuenda	كُوسُويِنْدَا
كوتولا	Cotulla	كُوتُولَا
المهزة	Mahazza	مَهَزَّة
كوفيل	Covell	كُوفِيل
دباغ	Dabagh	دَبَاغ
داغوبان	Dagupan	دَاغُوبَان
بلوتو	Pluto	بْلُوتُو
مارسيل	Marcel	مَارْسِيل
كونتاجيم	Contagem	كُونْتَاجِيم
مارية	Maria	مَارِيَة
كوربيل	Corbeil	كُورْبِيل
كورفو	Corfu	كُورْفُو
كورونافاك	CoronaVac	كُورُونَافَاك
كورتيغانا	Cortegana	كُورْتِيغَانَا
كورتس	Cortese	كُورْتِس
كاساتو	Cossato	كَاسَاتُو
داهومي	Dahomey	دَاهُومِي
درشغفت	Dareshgeft	دَرِشْغِفْت
درمار	Darmar	دَرْمَار
ماكلين	McLean	مَاكْلِين
كوتولا	Cotula	كُوتُولَا
دلجلي	Daljeli	دَلْجِلِي
المنارة	Menara	مِنَارَة
كورنت	Courant	كُورَنْت
كورتولد	Courtauld	كُورْتُولْد
دالوا	Daloa	دَالُوَا
كوارتاس	Cuartas	كُوَارْتَاس
كوكوميس	Cucumis	كُوكُومِيس
المطلة	Metula	مِطُلَة
بولينا	Polina	بُولِينَا
الملاجة	Milaja	مِلَاجَة
سركان	Sarkan	سَرْكَان
ديامس	Diam's	دِيَامْس
بولينا	Pollina	بُولِينَا
بوليناغو	Polinago	بُولِينَاغُو
بولينكوف	Polincove	بُولِينْكُوف
موييز	Moiez	مُويِيز
بولفينون	Pulvinone	بُولْفِينُون
كوريا	Curea	كُورِيَا
كوزكو	Cuzco	كُوزْكُو
دادنجان	Dadenjan	دَادِنْجَان
دغروب	Daghrub	دَغْرُوب
بومرمان	Böhmermann	بُومَرْمَان
بومبينو	Bombino	بُومْبِينُو
داركولي	Darkubi	دَارْكُولِي
ديكورا	Dekorra	دِيكُورَا
دوليني	Deligny	دُولِينِي
دانبي	Danby	دَانْبِي
دانسفهان	Danesfahan	دَانِسْفَهَان
دانفورث	Danforth	دَانْفُورْث
ديول	Dhule	دِيُول
بونتيان	Pontian	بُونْتِيَان
بونور	Ponor	بُونُور
بوراشد	Bouchared	بُورَاشِد
النواصر	Nouaceur	نُوَاصِر
النعمان	Nu'man	نُعْمَان
بوريبيستا	Burebista	بُورِيبِيسْتَا
بوريسوف	Borisov	بُورِيسُوف
دانغجين	Dangjin	دَانْغْجِين
اوادا	Ouadda	أُوَادَا
دارانداش	Darandash	دَارَانْدَاش
دارينزيا	Darenzia	دَارِينْزِيَا
دسوق	Desouk	دِسُوق
دواي	Douai	دُوَاي
داشلوجة	Dashlujeh	دَاشْلُوجَة
دستجا	Dastja	دَسْتْجَا
بوردونكل	Bourdoncle	بُورْدُونْكِل
بورليدم	Burleydam	بُورْلِيدَم
بورنيو	Borneo	بُورْنِيُو
بيكريل	Pickrell	بِيكْرِيل
بورتاغ	Portage	بُورْتَاغ
بورتي	Börte	بُورْتِي
دوغاي	Daugai	دُوغَاي
دولان	Dolan	دُولَان
بيتون	Python	بَيْتُون
دولان	Doolan	دُولَان
دولان	Dulan	دُولَان
كويته	Quetta	كُوِيتَّه
دافتاشين	Davtashen	دَافْتَاشِين
دليجة	Delijeh	دَلِيجَة
وولسي	Woolsey	وُولْسِي
دلابلين	Delaplane	دِلَابْلِين
ديرنكويو	Derinkuyu	دِيرِنْكُويُو
ديموبوليس	Demopolis	دِيمُوبُولِيس
بوتشام	Poocham	بُوتْشَام
بوتشيوم	Bucium	بُوتْشِيُوم
بوتشو	Bozhou	بُوتْشُو
ريبلاي	Ripley	رِيبْلَاي
بوتكن	Botkin	بُوتْكِن
بوتلاتش	Potlatch	بُوتْلَاتْش
بوتليتز	Putlitz	بُوتْلِيتْز
دروئية	Deruiyeh	دُرُوئِيَّة
ديتكت	Detekt	دِيتِكْت
ديفسنا	Devasena	دِيفَسِنَا
دختشا	Dexcha	دَخْتْشَا
ديايوس	Diaeus	دِيَايُوس
ديديندورف	Diedendorf	دِيدِينْدُورْف
ديبهولتس	Diepholz	دِيبْهُولْتْس
إيشووا	Isuwa	إِيشُووَا
ديلينجهام	Dillingham	دِيلِينْجْهَام
دينوقراطيس	Dinocrates	دِينُوقْرَاطِيس
دميتروف	Dmitrov	دْمِيتْرُوف
جوندت	Dogali	جُونْدْت
الصرمان	Sarman	صَرْمَان
دوي	Doi	دُوي
دوكوم	Dokkum	دُوكُوم
دولاند	Doland	دُولَانْد
دولوفو	Dolovo	دُولُوفُو
دمية	Domiyeh	دُمِيَّة
دونالدسون	Donaldson	دُونَالْدْسُون
دورجالي	Dorgali	دُورْجَالِي
دورمير	Dormer	دُورْمِير
دهشال	Dehshal	دِهْشَال
دهلان	Dehlan	دِهْلَان
دوروثيا	Dorothea	دُورُوثِيَا
دوروثيوس	Dorotheus	دُورُوثِيُوس
درامان	Dramane	دْرَامَان
آكسلاخ	Achslach	آكْسْلَاخ
سيميون	Simeon	سِيمِيُون
عرعر	Aaraar	عَرْعَر
عرعر	Arar	عَرْعَر
عرعر	Juniperus	عَرْعَر
عروى	Arwa	عَرْوَى
آلميره	Almere	آلْمِيرِه
دوروثي	Dorothy	دُورُوثِي
صوتتل	Sotetel	صَوْتِتِل
السوالم	Soualem	سُوَالِم
ستاهيل	Stahel	سْتَاهِيل
دوربة	Dowrbeh	دَوْرْبَة
دويرة	Doveyreh	دُوَيْرَة
عملاق	Giant	عِمْلَاق
عملاق	Jötnar	عِمْلَاق
عرسال	Arsal	عَرْسَال
شيييل	Sheeel	شِييِيل
دزدبند	Dozdband	دُزْدَبَنْد
دهميت	Dihmīt	دِهْمِيت
دبيلة	Dubaylah	دُبَيْلَة
فائز	Faiz	فَائِز
الطميعة	Tamiya	طَمِيعَة
فاضل	Fadhel	فَاضِل
فاضل	Fadil	فَاضِل
دوديان	Dudyan	دُودِيَان
درازدوف	Drozdov	دْرَازْدُوف
دومكا	Dumka	دُومْكَا
دونايفتسي	Dunaivtsi	دُونَايِفْتْسِي
دونريث	Dunreith	دُونْرِيث
تانيسر	Thanesar	تَانِيسَر
دورانوس	Duranus	دُورَانُوس
ديكلان	Declan	دِيكْلَان
دوربي	Durbe	دُورْبِي
ديلاند	DeLand	دِيلَانْد
دوربين	Durbin	دُورْبِين
ديلولو	Dilolo	دِيلُولُو
دورجا	Durga	دُورْجَا
دوريان	Durio	دُورِيَان
دوستك	Dustak	دُوسْتَك
توسرت	Twosret	تُوسْرِت
تزيليم	Tze'elim	تْزِيلِيم
دوزاني	Dužani	دُوزَانِي
دريما	Dreama	دْرِيمَا
جونغاريا	Dzungaria	جُونْغَارِيَا
عبا	Ebba	عَبَا
أميرطاغ	Emirdağ	أَمِيرْطَاغ
فيجيتو	Vegerot	فِيجِيتُو
أنسيغة	Ensigha	أَنْسِيغَة
فيناي	Vinay	فِينَاي
أرمنيك	Ermenek	أَرْمِنِيك
فيروزة	Fairouzeh	فَيْرُوزَة
فالوغا	Falougha	فَالُوغَا
ويذرز	Withers	وِيذَرْز
فانينج	Fanning	فَانِينْج
فانتلاب	FantLab	فَانْتْلَاب
فراهنغ	Farahak	فَرَاهَنْغ
يوناو	YouNow	يُونَاو
يومبى	Yumbe	يُومْبَى
بوكنآو	Bockenau	بُوكِنْآو
فرندن	Farndon	فَرْنْدُن
فاستلي	Fastly	فَاسْتْلِي
فاريويل	Favreuil	فَارْيُويِل
فريدريكا	Federica	فِرِيدْرِيكَا
فاتن	Fatin	فَاتِن
زدينيك	Zdeněk	زْدِينِيك
فيشوبف	Feechopf	فِيشُوبْف
فاتو	Fatou	فَاتُو
فلارغ	Felarg	فِلَارْغ
فيلزمير	Fellsmere	فِيلْزْمِير
بورتون	Burraton	بُورَتُون
بورغور	Borgore	بُورْغُور
العابدين	Abidin	عَابِدِين
فرناندو	Fernando	فِرْنَانْدُو
عادوله	Adel	عَادُولَه
بورتون	Burrton	بُورْتُون
بورتون	Burton	بُورْتُون
فيراري	Ferrari	فِيرَارِي
اغاديت	Aghadit	أَغَادِيت
فروخي	Ferroukhi	فِرُّوخِي
فريفيل	Ferryville	فِرِيفِيل
البويرق	Al-Buwayraq	بُوَيْرَق
الغريفة	Al-Ghurayfah	غُرَيْفَة
الحرية	Al-Horria	حُرِّيَّة
الحرية	Al-Hurriya	حُرِّيَّة
الخريبة	Al-Khuraybah	خُرَيْبَة
المكاريب	Al-Makarib	مَكَارِيب
المحيبس	Al-Mihaybis	مِحَيْبِس
المنتجه	Al-Mintajjah	مِنْتَجَّه
المغسيل	Al-Mughsayl	مُغْسَيْل
المختلط	Al-Mukhtalat	مُخْتَلَط
المريغة	Al-Murayghah	مُرَيْغَة
فيتشيوكس	Ficheux	فِيتْشْيُوكْس
المطيول	Al-Mutaywil	مُطَيْوِل
النعاني	Al-Na'ani	نَعَانِيّ
فيدالغو	Fidalgo	فِيدَالْغُو
الوديات	Al-Widayyat	وِدَيَّات
القطامي	Alcoutim	قَطَامِيّ
فيركرست	Fircrest	فِيرْكْرِسْت
ألخاستي	Alkhasty	أَلْخَاسْتِي
فيروزة	Firuze	فِيرُوزَة
فنيدق	Fnaydeq	فْنَيْدِق
فوليت	Follett	فُولِيت
فروديسي	Fordyce	فُرُودِيسِي
فورمجيني	Formigine	فُورْمِجِينِي
فورستر	Forrester	فُورِسْتَر
فريدريكا	Frederica	فْرِيدِرِيكَا
فورشيا	Forchia	فُورْشِيَا
فرعم	Fir'im	فِرْعِم
فريدريكا	Frederika	فْرِيدِرِيكَا
اشتقل	Ashtaqal	أَشْتَقَل
فروند	Freund	فْرُونْد
فورستر	Förster	فُورْسْتَر
أتابوبو	Atapupu	أَتَابُوبُو
فوسفوريتو	Fosforito	فُوسْفُورِيتُو
دوريان	Dorian	دُورِيَان
فوشانة	Fouchana	فُوشَانَة
فوكسس	Foxes	فُوكْسِس
فريقات	Frikat	فْرِيقَات
فروغن	Frogn	فْرُوغْن
فرومرز	Frommer's	فْرُومَرْز
فروند	Fronde	فْرُونْد
فروساسكو	Frossasco	فُرُوسَّاسْكُو
فريفيل	Freeville	فْرِيفِيل
بنديكت	Benedict	بِنِدِيكْت
فرويتا	Fruita	فْرُويِتَا
فليحة	Fulayhah	فُلَيْحَة
غالاشر	Gallacher	غَالَاشَر
فريسا	Frisa	فْرِيسَا
غالودورو	Gallodoro	غَالُّودُورُو
غاردنديل	Gardendale	غَارْدِنْدِيل
غاريدو	Garrido	غَارِّيدُو
غاوديوسة	Gaudiosa	غَاوْدِيُوسَة
غوميشان	Gavmishan	غَوْمِيشَان
غلوكوكيناز	GCK	غْلُوكُوكِينَاز
فولدابروك	Fuldabrück	فُولْدَابْرُوك
جبرائيل	Gabriel	جِبْرَائِيل
فريتان	Fritan	فْرِيتَان
غيديس	Geddes	غِيدِيس
جينالوجيكش	Genealogics	جِينَالُوجِيكْش
جمالائيل	Gamaliel	جَمَالَائِيل
غامبرو	Gambro	غَامْبْرُو
فيندآخ	Windach	فِينْدَآخ
غامتوغ	Gamtog	غَامْتُوغ
فيست	Feist	فِيسْت
فيستبي	Vestby	فِيسْتْبِي
غاردا	Garda	غَارْدَا
فيتورينو	Vitorino	فِيتُورِينُو
غيراتشي	Gerace	غِيرَاتْشِي
فلاورز	Flowers	فْلَاوَرْز
غرامي	Gerami	غِرَامِي
فلينت	Flint	فْلِينْت
فلينت	Flynt	فْلِينْت
فلور	Flor	فْلُور
فلور	Flore	فْلُور
فلور	Fluor	فْلُور
سيدايلو	Cedillo	سِيدَايْلُو
فرانكا	Franca	فْرَانْكَا
فرانس	France	فْرَانْس
فرانس	Frans	فْرَانْس
الشلالة	Chellala	شِلَّالَة
غازاندا	Gasanda	غَازَانْدَا
شيكني	Chiconi	شِيكُنِي
غرداب	Gerdab	غِرْدَاب
غانيون	Ghanaians	غَانِيّ
تشويزا	Choiza	تْشُويْزَا
غنامة	Ghanamah	غَنَامَة
جايوني	Giaglione	جَايُونِي
غزمنزل	Gazmanzel	غَزْمَنْزِل
تشوريا	Ciurea	تْشُورِيَا
فوستون	Fosston	فُوسْتُون
كلويه	Giluyeh	كِلُويِه
جيفنشي	Givenchy	جِيفِنْشِي
غليتر	Goleytar	غُلَيْتَر
غارفان	Garvan	غَارْفَان
غيغاروت	Gegharot	غِيغَارُوت
جيلدارت	Geldart	جِيلْدَارْت
غرغيتش	Gorgich	غُرْغِيتْش
جيلتيندورف	Geltendorf	جِيلْتِينْدُورْف
جورمان	Gorman	جُورْمَان
جينوكي	GENUKI	جِينُوكِي
ددوود	Deadwood	دِدْوُود
جيوجراف	Geograph	جِيُوجْرَاف
ديكوراه	Decorah	دِيكُورَاه
الدغيمة	Degaimah	دِغَيْمَة
غورونتالو	Gorontalo	غُورُونْتَالُو
جورجيانا	Georgiana	جُورْجِيَانَا
غوسنولد	Gosnold	غُوسْنُولْد
الدغالي	Dgali	دْغَالِيّ
جيراردو	Gerardo	جِيرَارْدُو
غوتليب	Gottlieb	غُوتْلِيب
جرمانيا	Germania	جِرْمَانِيَا
جيرمانو	Germano	جِيرْمَانُو
عمالقة	Giants	عَمَالِقَة
هيغانغ	Hegang	هِيغَانْغ
هيستون	Hesston	هِيسْتُون
دوفربن	Douvrin	دُوفْرَبْن
جبعون	Gibeon	جِبْعُون
جيلمور	Gilmore	جِيلْمُور
غوركوف	Gourcuff	غُورْكُوف
غوراند	Gowrand	غُورَانْد
فيشترزباخ	Wächtersbach	فِيشْتَرْزْبَاخ
غورسدورف	Gœrsdorf	غُورْسْدُورْف
غولدبرغ	Goldberg	غُولْدْبِرْغ
غوراوان	Gowravan	غُورَاوَان
غوزديكه	Gozdeyka	غُوزْدِيكَه
غولسن	Golßen	غُولْسَن
غاكل	Gackle	غَاكِل
البلينا	El-Balyana	بَلْيَنَا
غودفيو	Goodview	غُودْفِيُو
غالفان	Galván	غَالْفَان
غودش	Gozo	غَوْدَش
فيليج	Velizh	فِيلِيج
كنفودة	Guenfouda	كُنْفُودَة
غوغتشين	Gugchin	غُوغْتْشِين
جوجرانوالا	Gujranwala	جُوجْرَانْوَالَا
غانس	Gans	غَانْس
غانون	Gagnon	غَانُون
فيلوبابوس	Philopappos	فِيلُوبَابُوس
فيلومينا	Philomena	فِيلُومِينَا
جولشان	Gülşen	جُولْشَان
كاشتون	Cashton	كَاشْتُون
غونيان	Gunian	غُونِيَان
غونجيك	Gunjik	غُونْجِيك
غونيسون	Gunnison	غُونِيسُون
غايل	Gaels	غَايِل
غايل	Gayle	غَايِل
غايل	Guile	غَايِل
الفرقلس	Furqlus	فُرْقْلُس
جونتران	Guntram	جُونْتْرَان
غوستافوس	Gustavus	غُوسْتَافُوس
غوترسلوه	Gütersloh	غُوتَرْسْلُوه
غرفهم	Grafham	غْرَفْهَم
غريبو	GhuraybU	غُرَيْبُو
غريب	Greip	غْرِيب
غوزنان	Guznan	غُوزْنَان
جيوشيفو	Gyueshevo	جِيُوشِيفُو
غسان	Ghassān	غَسَّان
حبروت	Habrut	حَبْرُوت
فلانيجان	Flanigan	فْلَانِيجَان
غندكرو	Gondokoro	غُنْدُكُرُو
فليفيل	Fléville	فْلِيفِيل
هاكايناس	Hacinas	هَاكَايْنَاس
حدثا	Hadatha	حَدَثَا
كرامة	Gourrama	كُرَامَة
حفيظة	Hafida	حَفِيظَة
هفتومان	Haftuman	هَفْتُومَان
حجاي	Haggai	حَجَّاي
غلاس	Glass	غْلَاس
هايدونغ	Haidong	هَايْدُونْغ
غلينمورا	Glenmora	غْلِينْمُورَا
غرابيز	Grabež	غْرَابِيز
غويريت	Guéret	غُويِرْيِت
حجاجي	Hajjaji	حَجَّاجِيّ
هامالاند	Hamaland	هَامَالَانْد
غرينلاند	Greenland	غْرِينْلَانْد
غرينلاند	Greenlands	غْرِينْلَانْد
حماميان	Hammamian	حَمَّامِيَان
هاموند	Hammond	هَامُونْد
هانبي	Hanbi	هَانْبِي
كيسانغ	Kesang	كِيسَانْغ
هانسبورو	Hansboro	هَانْسْبُورُو
هاراشريت	Haracherite	هَارَاشِرِيت
هراران	Hararan	هَرَارَان
هرازيجان	Harazijan	هَرَازِيجَان
حربيل	Harbil	حَرْبِيل
فولفاخ	Wolfach	فُولْفَاخ
الحرية	Hurriyeh	حُرِّيَّة
هارديفيل	Hardeeville	هَارْدِيفِيل
ايكافا	Iecava	إِيكَافَا
هاردغسن	Hardegsen	هَارْدِغْسَن
هادرين	Hardin	هَادِرِين
إيونيا	Ionia	إِيُونِيَا
فوركاري	Forcarei	فُورْكَارِي
هاريسفيل	Harrisville	هَارِيسْفِيل
هارتفرد	Hartford	هَارْتْفُرْد
هارتموت	Hartmut	هَارْتْمُوت
هرزنديق	Harzandiq	هَرْزَنْدِيق
حسنجان	Hasanjan	حَسَنْجَان
حتحور	Hathor	حَتْحُور
جانسون	Jansson	جَانْسُون
هواشانق	Havashanq	هَوَاشَانْق
حويق	Haviq	حَوِيق
هيبل	Hebel	هِيبِل
جريكو	Jericho	جِرِيكُو
هبيرة	Hebira	هِبِيرَة
حبكوش	Hebkouch	حِبْكُوش
جانسون	Johnson	جَانْسُون
غارينولا	Grainola	غَارِينُولَا
كآرينا	Kaarina	كَآرِينَا
هاميدال	Heimdall	هَامِيدَال
كانيشكا	Kanishka	كَانِيشْكَا
هلاب	Hellab	هِلَاب
هيمنغز	Hemmings	هِيمِنْغْز
هرقليطس	Heraclitus	هِرَقْلِيطُس
هرنانديز	Hernández	هِرْنَانْدِيز
حرنيت	Herneith	حِرْنِيت
هيريرياس	Herrerías	هِيرِّيرِيَاس
هيرتويغ	Hertwig	هِيرْتْوِيغ
هيسدين	Hesdin	هِيسْدِين
غريغلا	Grygla	غْرِيغْلَا
هكسلي	Hexley	هِكْسْلِي
هبالة	Hibalah	هِبَالَة
غيرشام	Gresham	غِيرْشَام
هيغاشيكاوا	Higashikawa	هِيغَاشِيكَاوَا
غلينبروك	Glenbrook	غْلِينْبْرُوك
غريفنتال	Gräfenthal	غْرِيفِنْتَال
غرينوك	Greenock	غْرِينُوك
الخريبة	Khraibeh	خْرَيْبَة
غروبس	Grubbs	غْرُوبْس
هيلر	Hiller	هِيلَر
هيبشيم	Hipsheim	هِيبْشَيْم
حميمات	Hmeimat	حُمَيْمَات
هواني	Hoani	هُوَانِي
هارفل	Harvel	هَارْفِل
هارلم	Haarlem	هَارْلِم
هارلم	Harlem	هَارْلِم
هارلو	Harlow	هَارْلُو
هودجيتش	Hodžić	هُودْجِيتْش
ميلوود	Melwood	مِيلْوُود
ميلوود	Millwood	مِيلْوُود
العذاري	Ladhari	عَذَارِيّ
هوغانسفيل	Hogansville	هُوغَانْسْفِيل
الخنافيف	Lakhnafif	خْنَافِيف
هونشتاين	Hohnstein	هُونْشْتَايْن
هولنديل	Hollandale	هُولَنْدِيل
هوريكون	Horicon	هُورِيكُون
هورفاث	Horvath	هُورْفَاث
هورفاث	Horváth	هُورْفَاث
الحرية	Liberté	حُرِّيَّة
الحرية	Liberty	حُرِّيَّة
هوشع	Hosea	هُوشَع
هونسلو	Hounslow	هُونْسْلُو
هواردفيل	Howardville	هَوَارْدْفِيل
لولورث	Lolworth	لُولْوُرْث
لوميلو	Lomello	لُومِيلُّو
هودرج	Hudaraj	هُودَرَج
هوندسدورف	Hundsdorf	هُونْدْسْدُورْف
هونيدوارا	Hunedoara	هُونِيدُوَارَا
هكسلي	Huxley	هَكْسْلِي
هايدرو	Hydro	هَايْدْرُو
موسيي	Musei	مُوسِيِي
حلبي	Halabi	حَلَبِيّ
حلواني	Halawani	حَلَوَانِيّ
هيميتوس	Hymettus	هَيْمِيتُوس
هيندبورن	Hyndburn	هِينْدْبُورْن
أخرنوفرت	Ikhernofret	أَخِرْنُوفْرِت
حنة	Hannah	حَنَّة
حران	Haran	حَرَان
حران	Harran	حَرَّان
عميقة	Imayqah	عِمَيْقَة
عمانوئيل	Immanuel	عَمَانُوئِيل
إيشي	Ishii	إِيشِي
أيار	Iyar	أَيَّار
جبرند	Jabbarand	جَبَرَنْد
جبرائيل	Jabrayil	جَبْرَائِيل
جاكسبورو	Jacksboro	جَاكْسْبُورُو
جدوعة	Jadduah	جَدُّوعَة
جالاندهار	Jalandhar	جَالَانْدْهَار
جامايكا	Jamaica	جَامَايْكَا
جامبا	Jamba	جَامْبَا
جامكان	Jamkan	جَامْكَان
مركاوغ	Markaughe	مَرْكَاوْغ
حيفة	Hayfah	حَيْفَة
حكمت	Hikmat	حِكْمَت
هندريك	Hendrick	هِنْدْرِيك
هندريك	Hendrik	هِنْدْرِيك
قوتلي	Al-Quwatli	قُوتْلِيّ
جاموس	Jamous	جَامُوس
ميديكير	Medicare	مِيدِيكِير
الماجري	Mejri	مَاجِرِيّ
جانينا	Janina	جَانِينَا
جنتر	Jantar	جَنْتَر
جرابلس	Jarabulus	جَرَابُلُس
جيفرسون	Jefferson	جِيفِرْسُون
جيرميتش	Jeremić	جِيرِمِيتْش
جهللال	Jhulelal	جُهُلِّلَال
الماتلين	Metline	مَاتِلِين
جيانغنا	Jiangna	جِيَانْغْنَا
جياوان	Jiavan	جِيَاوَان
جيايوقوان	Jiayuguan	جِيَايُوقُوَان
هيكاري	Hikari	هِيكَارِي
هيرا	Hera	هِيرَا
جيموان	Jimeoin	جِيمُوَان
جينغتشو	Jingzhou	جِينْغْتْشُو
موليهوي	Møllehøj	مُولِيهُوي
جريف	Jirayf	جِرَيْف
جمول	Jmol	جْمُول
جداقية	Jodaqayeh	جُدَاقَيَة
جداقية	Jodaqiyeh	جُدَاقِيَة
جوينفيل	Joinville	جُوِينْفِيل
جونزفيل	Jonesville	جُونْزْفِيل
جونيشكليس	Joniškėlis	جُونِيشْكِلِيس
جوزيففيل	Josephville	جُوزِيفْفِيل
جوتسا	Joutsa	جُوتْسَا
جزينان	Jozinan	جُزِينَان
جيانز	Juanes	جُيَانِز
جبا	Jubba	جُبَّا
جبى	Jubba	جُبَّى
جولياناتوب	Julianatop	جُولِيَانَاتُوب
كباشين	Kabbachin	كَبَّاشِين
كادنيكوف	Kadnikov	كَادْنِيكُوف
كفرقاهل	Kaferkahel	كِفْرْقَاهِل
كاهاتويتة	Kahatowita	كَاهَاتُوِيتَة
كاولوي	Kahului	كَاوُلُوِي
كاخوفكا	Kakhovka	كَاخُوفْكَا
هولدر	Holder	هُولْدَر
هومادا	Humada	هُومَادَا
كلجك	Kalejak	كَلِجَك
كليتشة	Kalicheh	كَلِيتْشَة
كاماخيا	Kamakhya	كَامَاخْيَا
كاميكواني	Kamikoani	كَامِيكُوَانِي
كامينوكوني	Kaminokuni	كَامِينُوكُونِي
كامياران	Kamyaran	كَامِيَارَان
كاميزياك	Kamyzyak	كَامِيزْيَاك
كناسألا	Kangasala	كَنَاسَأَلَا
كاوري	Kaori	كَاوُرِي
كرامة	Karameh	كَرَامَة
كرندق	Karandaq	كَرَنْدَق
كاريزدر	Karizdar	كَارِيزْدَر
كركوج	Karkoj	كَرْكُوج
كركوش	Karkush	كَرْكُوش
كرمانة	Karmana	كَرْمَانَة
كارنال	Karnal	كَارْنَال
كارولوس	Karolos	كَارُولُوس
كاربينسك	Karpinsk	كَارْبِينْسْك
بوفهام	Pavenham	بَوْفَهَام
كاراثا	Karratha	كَارَاثَا
كرسعة	Karsaa	كَرْسَعَة
كاروزي	Karuzi	كَارُوزِي
كيشيون	Kassites	كِيشِيّ
كاسنر	Kassner	كَاسْنَر
كتفاء	Katfā'	كَتْفَاء
كوسي	Kavsi	كَوْسِي
كواتشي	Kawachi	كَوَاتْشِي
كِيتا	Keïta	كِيتَا
كليسان	Kelisan	كِلِيسَان
كمبرغ	Kemberg	كِمْبِرْغ
جريف	Jarif	جَرِيف
كنسورته	Kensworth	كِنْسْوُرْتَه
كينيا	Kenya	كِينْيَا
كروشن	Kerrouchen	كِرُّوشِن
ويرتون	Weirton	وِيرْتُون
كيزفيل	Keysville	كِيزْفِيل
خمي	Khommi	خُمِّي
ووجينغ	Wujing	وُوجِينْغ
خشوئية	Khoshuiyeh	خُشُوئِيَّة
كيغال	Kighal	كِيغَال
كيموتو	Kimoto	كِيمُوتُو
كيموتسوكي	Kimotsuki	كِيمُوتْسُوكِي
كنغزغروف	Kingsgrove	كِنْغْزْغْرُوف
كينتنر	Kintner	كِينْتْنِر
كينتور	Kintore	كِينْتُور
كريب	Kirayb	كِرَيْب
كيركباتريك	Kirkpatrick	كِيرْكْبَاتْرِيك
كريستي	Kirsty	كِرِيسْتِي
الروملي	Rumelia	رُومِلِيّ
ساغينيه	Saguenay	سَاغِينَيْه
ساليغني	Saligny	سَالِيغْنِي
كيتاغاوا	Kitagawa	كِيتَاغَاوَا
كيتاياما	Kitayama	كِيتَايَامَا
كيتينغر	Kittinger	كِيتِينْغَر
كيتسشر	Kitzscher	كِيتْسْشَر
دنيصر	Kızıltepe	دُنَيْصَر
كنيتلينغن	Knittlingen	كْنِيتْلِينْغِن
كنونو	Knonau	كْنُونَو
كولوبه	Koloppeh	كُولُوبِّه
كلوانق	Kolvanaq	كُلْوَانَق
شرمان	Sherman	شِرْمَان
كمدرة	Komdarreh	كَمْدَرَة
كميتك	Komitak	كُمِيتَك
شوبريا	Shupria	شُوبْرِيَا
كوندوبوغا	Kondopoga	كُونْدُوبُوغَا
كوريا	Korea	كُورِيَا
جيرو	Gero	جِيرُو
جيرو	Giraud	جِيرُو
جيرو	Giro	جِيرُو
جيرو	Jirō	جِيرُو
كوريا	Koriya	كُورْيَا
كرماكيتي	Kormakitis	كُرْمَاكِيتِي
كورور	Koror	كُورُور
كشكوئيه	Koshkuiyeh	كُشْكُوْئِيَه
كوسيليكا	Kosilka	كُوسِيلِيكَا
كوسي	Kosse	كُوسِّي
كوتاكه	Kotake	كُوتَاكْه
كوتايام	Kottayam	كُوتَايَام
ستريت	Street	سْتْرِيت
جريجيو	Greggio	جْرِيجِيو
جريكو	Greco	جْرِيكُو
جروبون	Groupon	جْرُوبُون
كوغانك	Kuganak	كُوغَانَك
كوغلوكتوك	Kugluktuk	كُوغْلُوكْتُوك
كوخان	Kukhan	كُوخَان
كوماري	Kumari	كُومَارِي
كوريساري	Kuressaare	كُورِيسَارِي
كورجه	Kurjeh	كُورْجِه
كورزة	Kurzeh	كُورْزَة
كوسناخت	Küsnacht	كُوسْنَاخْت
آديفاسي	Adivasi	آدِيفَاسِي
كوتولشيم	Kuttolsheim	كُوتُولْشِيم
كوفانديك	Kuvandyk	كُوفَانْدِيك
كوفيمبو	Kuvempu	كُوفِيمْبُو
غوزدغن	Kuzdagan	غُوزْدَغَن
كوزنتسوفا	Kuznetsova	كُوزْنِتْسُوفَا
كفانوم	Kvänum	كْفَانُوم
لاغارتو	Lagarto	لَاغَارْتُو
لكفيفات	Lagfifat	لَكْفِيفَات
لاينغ	Laing	لَايِنْغ
مناذرة	Lakhmids	مَنَاذِرَة
لخوالقة	Lakhoualqa	لَخْوَالْقَة
لمعاشات	Lamaachate	لَمْعَاشَات
لانتشانو	Lanciano	لَانْتْشَانُو
لانديرد	Landerd	لَانْدِيرْد
لندودنك	Landewednack	لَنْدِوِدْنَك
لاندسهوت	Landshut	لَانْدْسْهُوت
لانسبورو	Lanesboro	لَانِسْبُورُو
لانغفورد	Langford	لَانْغْفُورْد
لنريث	Lanreath	لَنْرِيث
لانتيرا	Lanteira	لَانْتِيرَا
لانوسي	Lanusei	لَانُوسِي
لقراقرة	Laqraqra	لَقْرَاقْرَة
لاسان	Lassan	لَاسَان
لاشتروب	Lastrup	لَاشْتْرُوب
ترايبو	Traipu	تْرَايْبُو
لاويرسمير	Lauwersmeer	لَاوِيرْسْمِير
لزيرك	Lazirak	لَزِيرَك
لازيسي	Lazise	لَازِيسِي
توسايان	Tusayan	تُوسَايَان
ليتشفيل	Leachville	لِيتْشْفِيل
برايدن	Bryden	بْرَايْدِن
ليسلرفيل	Leclercville	لِيسْلِرْفِيل
ليدانيا	Ledaña	لِيدَانْيَا
ليسفيل	Leesville	لِيسْفِيل
ليجوشي	Legoshi	لِيجُوشِي
ليرمان	Lehrman	لِيرْمَان
ليرته	Lehrte	لِيرْتِه
ليسوركورب	Leisurecorp	لِيسُورْكُورْب
ليمونوير	Lemonweir	لِيمُونْوِير
لينغدورف	Lengdorf	لِينْغْدُورْف
لنغريش	Lengerich	لِنْغَرِيش
كاناب	Kanab	كَانَاب
كاناي	Cannae	كَانَاي
كاناي	Kanae	كَانَاي
كاناي	Kanai	كَانَاي
كانيفيل	Caneyville	كَانِيفِيل
كانديس	Candice	كَانْدِيس
كانغ	Kang	كَانْغ
لينغفيل	Lengwil	لِينْغْفِيل
ليوماكس	Leomacs	لِيُومَاكْس
كارال	Caral	كَارَال
ليوبولد	Leopold	لِيُوبُولْد
ليشان	Leshan	لِيشَان
لوتزيغن	Leuzigen	لُوتْزِيغِن
ليلانة	Leylaneh	لَيْلَانَة
ليبيركورت	Libercourt	لِيبِيرْكُورْت
ديوندن	Dunedin	دِيُونْدِن
ايزدان	Yazata	إِيزْدَان
ليسينزا	Licenza	لِيسِينْزَا
ليندي	Lindi	لِينْدِي
لينغن	Lingen	لِينْغِن
ليوتا	Liotta	لِيُوتَّا
ليقناب	Liqenab	لِيقِنَاب
ليتشفيل	Litchville	لِيتْشْفِيل
ليتلز	Littles	لِيتِلْز
ليليانا	Ljiljana	لِيِلْيَانَا
ليوسينا	Ljusina	لْيُوسِينَا
لانتريسانت	Llantrisant	لَانْتْرِيسَانْت
لوغانديل	Logandale	لُوغَانْدِيل
لوريتا	Loretta	لُورِيتَّا
لورزيني	Lowrzini	لُورْزِينِي
لوبوكلنغاو	Lubuklinggau	لُوبُوكْلِنْغَاو
لوساجيوغ	Lusagyugh	لُوسَاجِيُوغ
ليفورد	Lyford	لِيفُورْد
ليسيثيا	Lysithea	لِيسِيثِيَا
مريرت	M'Rirt	مْرِيرْت
مصيسي	M'Ssici	مْصِيسِي
أديمي	Adeyemi	أَدِيمِي
معوج	Ma'Uj	مَعُوج
اغريجه	Agarijeh	أَغَرِيجِه
معوج	Ma'waj	مَعْوَجّ
مبيطح	Mabaytih	مَبَيْطِح
مابسكوت	Mabscott	مَابْسْكُوت
العويقيل	Al-Awayqil	عُوَيْقِيل
الحبيلات	Al-habilat	حَبِيلَات
الجرنية	Al-Jarniyah	جَرْنِيَّة
المهجورة	Al-Mahjurah	مَهْجُورَة
المديفي	Al-Mudayfi	مُدَيْفِيّ
المريغات	Al-Murayghat	مُرَيْغَات
ماينولشيم	Maennolsheim	مَايْنُولْشِيم
الويزية	Al-Wayziyya	وَيْزِيَّة
الزيلعي	Al-Zylaeei	زِيلْعِي
ألاتاير	Alatyr	أَلَاتَايْر
كايم	Caém	كَايِم
كايم	Caim	كَايِم
الكنتارا	Alcántara	أَلْكَنْتَارَا
كايلي	Keighley	كَايْلِي
كايلي	Kylie	كَايْلِي
كاظم	Kadhim	كَاظِم
ميف	Maeve	مَيْف
كفرود	Kafrud	كَفْرُود
كهلان	Kahlan	كَهْلَان
كهلان	Kohlan	كَهْلَان
كهلان	Kuhlan	كَهْلَان
مكاري	Makari	مَكَارِي
مخول	Makhoul	مَخُول
كلباء	Kalba	كَلْبَاء
كرابيفين	Krapivin	كْرَابِيفِين
مكي	Maki	مَكِي
مكي	Makki	مَكِّي
منابي	Manabe	مَنَابِي
ماندالت	Mandulatu	مَانْدَالَت
أقصري	Aqesri	أَقِصْرِي
مانيت	Mannette	مَانِيت
أركوي	Arcueil	أَرْكُوِيّ
أردينة	Ardineh	أَرْدِينَة
ماراكوس	Marracos	مَارَّاكُوس
مارتينيلي	Martinelli	مَارْتِينِيلِّي
مارواين	Marwayne	مَارْوَايْن
السحمية	As-Sahmiyah	سَحْمِيَّة
الصومحان	As-Sawmhan	صَوْمَحَان
هرستون	Harston	هَرْسْتُون
مرزيجران	Marzijaran	مَرْزِيجَرَان
ماشيكي	Mashiki	مَاشِيكِي
كلفتن	Clifton	كْلِفْتُن
ماساناس	Massanes	مَاسَانَاس
ماسوة	Masueh	مَاسُوَة
بايرويل	Bairoil	بَايْرُويِل
ماساكاوا	Masukawa	مَاسَاكَاوَا
مورة	Mawarah	مَوَرَة
ميادة	Mayada	مَيَّادَة
برانقار	Baranqar	بَرَانْقَار
مازيه	Maze	مَازِيه
مكاري	McCarey	مَكَّارِي
مشرنيش	Mechernich	مِشِرْنِيش
كريستي	Cristi	كْرِيسْتِي
مهمانلو	Mehmanlu	مِهْمَانْلُو
كريستي	Kristie	كْرِيسْتِي
كريستي	Kristy	كْرِيسْتِي
مكي	Mekki	مِكِّي
كريستيانا	Kristiana	كْرِيسْتِيَانَا
ملبة	Melaba	مِلَبَة
ملخاص	Melkhas	مِلْخَاص
مليتة	Mellita	مِلِيتَة
بيرشكا	Bershka	بِيرْشْكَا
ملوكي	Mellouki	مِلُّوكِي
ميناجيو	Menaggio	مِينَاجْيُو
بيوووتش	BioWatch	بَيُووُوتْش
منغن	Mengen	مِنْغِن
بودايبو	Bodaybo	بُودَايْبُو
منتوحتب	Mentuhotep	مِنْتُوحُتِب
موغيسي	Mevagissey	مِوَغِيسِي
ميزيزيوس	Mezezius	مِيزِيزِيُوس
محضان	Mihuan	مِحْضَان
مينوتور	Minotaur	مِينُوتَوْر
مريخ	Miraykh	مِرَيْخ
مريط	Mirbat	مَرِيط
مغيطية	Mogheytiyeh	مُغِيطِيَة
موليدو	Molledo	مُولِيدُو
مملو	Momlu	مُمْلُو
مونغيدورو	Monghidoro	مُونْغِيدُورُو
كليفيو	Clivio	كْلِيفِيُو
مونتبليار	Montbéliard	مُونْتْبْلِيَار
كيرتا	Kirta	كِيرْتَا
كيرو	Kero	كِيرُو
كيرو	Quero	كِيرُو
كارليان	Carlyn	كَارْلِيَان
كرمنيتسا	Kremnica	كْرِمْنِيتْسَا
مونتسكيو	Montesquieu	مُونْتِسْكْيُو
مونتيزوما	Montezuma	مُونْتِيزُومَا
كروكس	Crooks	كْرُوكْس
مونتريال	Montreal	مُونْتْرِيَال
كيتش	Ketch	كِيتْش
موريجيراتي	Morigerati	مُورِيجِيرَاتِي
كيوسافورتي	Chiusaforte	كِيُوسَافُورْتِي
الشرايبي	Chraïbi	شْرَايْبِيّ
كيوتكس	Cutex	كِيُوتِكْس
مورياس	Moryas	مُورْيَاس
كيزارو	Kizaru	كِيزَارُو
كرمباخي	Krompachy	كْرُمْبَاخِي
ميناق	Moynaq	مُيْنَاق
كوتياس	Cotillas	كُوتِيَّاس
مدل	Mudl	مُدْل
محينية	Muhayniyah	مُحَيْنِيَّة
ميورويتا	Murueta	مِيُورُويْتَا
سايبروس	Cyprus	سَايْبْرُوس
كلور	Chlorine	كْلُور
كلور	Clewer	كْلُور
موسكوتا	Muscotah	مُوسْكُوتَا
الدلفين	Delphinus	دِلْفِين
كريب	Creep	كْرِيب
موسو	Musso	مُوسُّو
موهرة	Muwahhirah	مُوَهَّرَة
موادي	Mwadui	مْوَادِي
ندافية	Naddafiyeh	نَدَّافِيَّة
نهلال	Nahalal	نَهْلَال
نهند	Nahend	نَهِنْد
الجريتلي	Elgretly	جْرِيتْلِي
القشاطي	Elkashati	قَشَّاطِيّ
ناخهري	Nakhahry	نَاخَهْرِي
كلور	Kolowr	كُلُور
نخجوان	Nakhchivan	نَخْجِوَان
نانوته	Nanauta	نَانُوتَه
نيبا	Neiba	نَيْبَا
كوشم	Cochem	كُوشِم
كوشيبا	Koshiba	كُوشِيبَا
كوشينجار	Kushinagar	كُوشِينَجَار
كوشينغ	Cushing	كُوشِينْغ
الفندارة	Findara	فِنْدَارَة
فينرتي	Finnerty	فِينِرْتِي
كوال	Kowal	كُوَال
كوال	Quahl	كُوَال
نيموشوفا	Nemšová	نِيمُوشُوفَا
نشلج	Neshlaj	نِشْلَج
نمولي	Nimule	نِمُولِي
كوبن	Coben	كُوبِن
نوبختي	Al-Nawbakhti	نَوْبَخْتِي
جابرييل	Gabrielle	جَابْرِييِل
غاليورن	Galehorn	غَالِيوُرْن
نيمور	Nimvar	نِيمُور
نعيضة	Nu'ayuah	نُعَيْضَة
أوبراين	O'Brien	أُوبْرَايَن
أوكفيل	Oakville	أُوكْفِيل
أوبوخيف	Obukhiv	أُوبُوخِيف
أوشنسايد	Oceanside	أُوشِنْسَايْد
أوتشيدان	Ocheyedan	أُوتْشِيدَان
أوجيرو	Ogero	أُوجِيرُو
أوغنين	Ognjen	أُوغْنِيَن
أولمان	Ohlman	أُولْمَان
غروسيتو	Grosseto	غْرُوسِّيتُو
أويابوكي	Oiapoque	أُويَابُوكِي
أوخانسك	Okhansk	أُوخَانْسْك
أوكوبو	Okubo	أُوكُوبُو
أولا	Ola	أُولَا
هجللا	Hagalella	هَجَلِلَّا
أولدهام	Oldham	أُولْدْهَام
الحمامات	Hammamet	حَمَّامَات
هامبدين	Hampden	هَامْبْدِين
الحردانة	Hardana	حَرْدَانَة
كونيغ	Koenig	كُونِيغ
كونيغ	Kœnig	كُونِيغ
كونيغامي	Kunigami	كُونِيغَامِي
كونيولي	Cugnoli	كُونِيُولِي
كونيولو	Coniolo	كُونِيُولُو
أوليفيلا	Olivella	أُولِيفِيلَا
هيرتويغ	Hertwigia	هِيرْتُويِغ
أولا	Olla	أُولَا
أولتينيا	Oltenia	أُولْتِينِيَا
أوموا	Omoa	أُومُوَا
أمورتاغ	Omurtag	أُمُورْتَاغ
أونيونتا	Oneonta	أُونِيُونْتَا
كونور	Connor	كُونُور
هيوستون	Houston	هِيُوسْتُون
هويشيان	Huixian	هُويِشْيَان
الخشنية	Hushnia	خُشْنِيَّة
كونور	Conor	كُونُور
كونور	Coonoor	كُونُور
أونونداج	Onondaga	أُونُونْدَاج
أوراديا	Oradea	أُورَادِيَا
إيويكا	Illueca	إِيُّوِيكَا
أوراهوفيكا	Orahovica	أُورَاهُوفِيكَا
إيموغين	Imogene	إِيمُوغِين
أوركاخو	Orcajo	أُورْكَاخُو
أوريجانوس	Origen	أُورِيجَانُوس
ازمورن	Izemmouren	إِزْمُورِن
أورلينس	Orleans	أُورْلِينْس
جاشإنأو	Jachenau	جَاشْإِنَأَو
جاسيندا	Jacinda	جَاسِينْدَا
جهندديز	Jahandiz	جَهَنْدْدِيز
أورودارا	Orodara	أُورُودَارَا
أوروسي	Orosei	أُورُوسِي
أورتوكيو	Ortucchio	أُورْتُوكِيُو
جونقلي	Jonglei	جُونْقِلِي
ويلسدن	Willesden	وِيلْسْدِن
أوسامو	Osamu	أُوسَامُو
أوشاكاتي	Oshakati	أُوشَاكَاتِي
أوزيريون	Osireion	أُوزِيرِيُون
عثمانية	Osmaniye	عُثْمَانِيَّة
أوسموند	Osmond	أُوسْمُونْد
خوجآباد	Khodjaobad	خُوجَآبَاد
كيغوورث	Kegworth	كِيغْوُورْث
أشروسنة	Osrūshana	أُشْرُوسَنَة
أوسيان	Ossian	أُوسِيَان
كوسم	Cosme	كُوسْم
أوزوالد	Oswald	أُوزْوَالْد
أطاقلو	Otaqlu	أُطَاقْلُو
أويدا	Ouidah	أُوَيْدَا
كينبرا	Kinbrae	كِينْبْرَا
ورياشي	Ouriachi	وَرِيَاشِي
أوينسفيل	Owensville	أُوِينْسْفِيل
أويري	Owerri	أُوِيرِي
أويري	Owiri	أُوِيرِي
أولق	Owlaq	أَوْلَق
الكريمات	Korimate	كُرَيْمَات
بابنا	Pabna	بَابْنَا
بانتن	Painten	بَانْتِن
بالجافيسي	Paljavesi	بَالْجَافِيسِي
بلامي	Palmy	بْلَامِي
كويكوى	Kwekwe	كْوِيكْوَى
لايكفيل	Lakeville	لَايْكْفِيل
لابل	LaBelle	لَابِل
لادنبورغ	Ladenburg	لَادِنْبُورْغ
بالومبارو	Palombaro	بَالُومْبَارُو
لاغاتا	Lagata	لَاغَاتَا
لامور	LaMoure	لَامُور
ليليانا	Liliana	لِيلِيَانَا
لُكانية	Lucania	لُكَانْيَة
بانكاج	Pankaj	بَانْكَاج
أرييلي	Arielli	أَرِييِلِّي
بانتان	Pantin	بَانْتَان
بابسوكيل	Papsukkal	بَابْسُوكِيل
برمهات	Paremhat	بَرِمْهَات
باريشفيل	Parishville	بَارِيشْفِيل
باركديل	Parkdale	بَارْكْدِيل
بارمالات	Parmalat	بَارْمَالَات
لاسا	Lassa	لَاسَا
لاسا	Lhasa	لَاسَا
برسبيت	Parsbit	بَرْسْبِيت
لاتيمر	Latimer	لَاتِيمَر
باسوروان	Pasuruan	بَاسُورُوَان
باتيرنو	Paterno	بَاتِيرْنُو
بولينا	Paulina	بَوْلِينَا
بباوليستا	Paulínia	بَبَاوُلِيسْتَا
بيتاف	Paytaf	بَيْتَاف
ميشيغان	Michigan	مِيشِيغَان
بيفكوخوري	Pefkochori	بِيفْكُوخُورِي
فقحيا	Pekahiah	فِقَحِيَا
بينلون	Pen-Lôn	بِينْلُون
آلنفيلد	Allenfeld	آلِنْفِيلْد
مونشاو	Monschau	مُونْشَاو
بيندير	Pender	بِينْدِير
المديفي	Muaifi	مُدَيْفِيّ
برنوثن	Perranuthnoe	بِرَنُوثْن
بيريفيل	Perryville	بِيرِيفِيل
نجاريان	Najarian	نَجَارِيَان
بابييفو	Babaevo	بَابَيِيفُو
نيانتيك	Niantic	نِيَانْتِيك
باكنانغ	Backnang	بَاكْنَانْغ
ناتزسسحي	Nitzsche	نَاتْزْسْسْحِي
بيرسيفون	Persephone	بِيرْسِيفُون
بيرشنغ	Pershing	بِيرْشِنْغ
بترسهاغن	Petershagen	بِتِرْسْهَاغِن
فورتسهايم	Pforzheim	فُورْتْسْهَايِم
باسفيلد	Bassfield	بَاسْفِيلْد
فولينغن	Pfullingen	فُولِينْغِن
عتنائيل	Otniel	عَتْنَائِيل
أوترياو	Outreau	أُوتْرِيَاو
أريوفستس	Ariovistus	أَرْيُوفِسْتَس
فونيكس	Phoenix	فُونِيكْس
بيلشتي	Pielești	بِيلِشْتِي
بيلونيا	Piloña	بِيلُونْيَا
بينيدا	Pineda	بِينِيدَا
باينيفيل	Pineville	بَايْنِيفِيل
ليرنا	Lerna	لِيرْنَا
بيركاني	Pirkani	بِيرْكَانِي
بيربنة	Pirbaneh	بِيرْبَنَة
بيرمازنز	Pirmasens	بِيرْمَازِنْز
برابهاس	Prabhas	بْرَابْهَاس
بوكروف	Pokrov	بُوكْرُوف
ليونيديو	Leonidio	لِيُونِيدْيُو
بولوكوان	Polokwane	بُولُوكْوَان
ليوتا	Ljuta	لِيُوتَا
القيسية	Qaysiyeh	قَيْسِيَّة
ليثارثا	Lizartza	لِيثَارْثَا
أرسينييف	Arsenyev	أَرْسِينِييِف
ليثيرا	Lécera	لِيثِيرَا
ليثبريدج	Lethbridge	لِيثْبْرِيدْج
بولوناروا	Polonnaruwa	بُولُونَارُوَا
بالفانتاش	Polvontosh	بَالْفَانْتَاش
بوبريكاني	Popricani	بُوبْرِيكَانِي
لوديانا	Ludhiana	لُودْيَانَا
لودويغ	Ludwig	لُودُوِيغ
لوفيليا	Lovilia	لُوفِيلِيَا
سنغالي	Sangli	سَنْغَالِي
لوفيرس	Luveris	لُوفِيرِس
ساتسوما	Satsuma	سَاتْسُومَا
أبينغدون	Abingdon	أَبِينْغْدُون
لوفليز	Lovelyz	لُوفْلِيز
لوغانثان	Loganathan	لُوغَانَثَان
بورشانغر	Porsanger	بُورْشَانْغَر
لوغروس	Lugros	لُوغْرُوس
لوجكوف	Luzhkov	لُوجْكُوف
لوكريشا	Lucretia	لُوكْرِيشَا
أورتستوك	Ortstock	أُورْتْسْتُوك
لوبينجر	Lobinger	لُوبِينْجَر
لوبود	Lopud	لُوبُود
لوكوست	Locust	لُوكُوسْت
لومبارد	Lombard	لُومْبَارْد
لومبيني	Lumbini	لُومْبِينِي
لوناكونينغ	Lonaconing	لُونَاكُونِينْغ
لورينزا	Lorenza	لُورِينْزَا
بورشه	Porsche	بُورْشْه
بورتسال	Portsall	بُورْتْسَال
بوشاغا	Poșaga	بُوشَاغَا
لوتشرا	Lucera	لُوتْشِرَا
بوتوماك	Potomac	بُوتُومَاك
لوتزوراي	Lotzorai	لُوتْزُورَاي
لويال	Loyal	لُويَال
لويال	Loyall	لُويَال
مذركير	Mothercare	مَذَرْكِير
مشاكوس	Machakos	مَشَاكُوس
سيمرايز	Symrise	سِيمْرَايْز
مشارب	Masharib	مَشَارِب
باويفيو	Powfu	بَاوِيفِيُو
ماشيكي	Mashike	مَاشِيكِي
بريسمان	Pressman	بْرِيسْمَان
تيواناكو	Tiwanaku	تِيوَانَاكُو
لورد	Lord	لُورْد
لورد	Lorde	لُورْد
لورد	Lourdes	لُورْد
بريوريس	Preures	بْرِيُورِيس
ماداكيت	Madaket	مَادَاكِيت
مادريد	Madrid	مَادْرِيد
ماكراكومي	Makrakomi	مَاكْرَاكُومِي
ورامدة	Varamdeh	وَرَامْدَة
مالوريني	Mălureni	مَالُورِينِي
مانارا	Manara	مَانَارَا
فارنغآو	Warngau	فَارْنْغَآو
فتوتس	Vytautas	فِتَوْتَس
ماناسلو	Manaslu	مَانَاسْلُو
وايتفيل	Whiteville	وَايْتْفِيل
ماناونغ	Manaung	مَانَاوَنْغ
ياجيروبي	Yajirobe	يَاجِيرُوبِي
مانزا	Manassa	مَانَزَا
برينسفيل	Princeville	بْرِينْسْفِيل
بريسمان	Prismane	بْرِيسْمَان
زاركينت	Zharkent	زَارْكِينْت
مانديانا	Mandiana	مَانْدِيَانَا
بركوسي	Prkosi	بْرْكُوسِي
فولرتون	Fullerton	فُولِرْتُون
ماراموريش	Maramureș	مَارَامُورِيش
فورفيلد	Fürfeld	فُورْفِيلْد
عجليبوول	Aglibol	عَجْلِيبُووْل
القصمتين	Al-Qasmitayn	قَصْمِتَيْن
الرحباني	Al-Rahbani	رَحْبَانِيّ
الشيباني	Al-Shaybani	شَيْبَانِيّ
اليعقوبي	Al-Yaqoubi	يَعْقُوبِيّ
مارانغوابي	Maranguape	مَارَانْغُوَابِي
ماريبا	Maripá	مَارِيبَا
مادوك	Maddock	مَادُوك
مادوك	Madoc	مَادُوك
مادون	Madun	مَادُون
ماريدي	Maridi	مَارِيدِي
ماغازين	Magazine	مَاغَازِين
ماغنيس	Magness	مَاغْنِيس
ماكامبا	Makamba	مَاكَامْبَا
ماكارا	Macará	مَاكَارَا
ماكاروف	Makarov	مَاكَارُوف
ماكي	Mackey	مَاكِي
ماكي	Maki	مَاكِي
ماكي	McKee	مَاكِي
ماريسا	Marisa	مَارِيسَا
ماكليمور	Macklemore	مَاكْلِيمُور
ماكلين	Maclean	مَاكْلِين
ماكلين	MacLean	مَاكْلِين
أرايتا	Arrieta	أَرَّايِتَا
ماكلين	McLain	مَاكْلِين
ماريسا	Marissa	مَارِيسَا
مارشي	Marchi	مَارْشِي
مارغريتا	Margarita	مَارْغَرِيتَا
هالتاون	Halltown	هَالْتَاوْن
مارساليا	Marsaglia	مَارْسَالْيَا
مارسيل	Marcelle	مَارْسِيل
مارتن	Martin	مَارْتِن
بخشايش	Bakhshayesh	بَخْشَايِش
بالابيو	Ballabio	بَالَّابِيُو
بالتساتس	Bălțați	بَالْتْسَاتْس
همبلدن	Hambleden	هَمْبِلْدِن
بانيولاس	Banyoles	بَانْيُولَاس
بروبرتيوس	Propertius	بْرُوبَرْتِيُوس
مانتل	Mantel	مَانْتِل
مارثا	Martha	مَارْثَا
باورامة	Bavrameh	بَاوَرَامَة
البقالطة	Bekalta	بِقَالْطَة
البلفيدير	Belvédère	بَلْفِيدِير
شاغونور	Shagonar	شَاغُونَوْر
بروكسي	Proxi	بْرُوكْسِي
بروكسي	Proxy	بْرُوكْسِي
بيددنهم	Biddenham	بِيدْدِنْهَم
بيثاغوريو	Pythagoreio	بِيثَاغُورِيُو
ماساي	Masai	مَاسَاي
ماسين	Maasin	مَاسِين
جيدبورغ	Jedburgh	جِيدْبُورْغ
ماريو	Mario	مَارِيُو
ماريو	Mário	مَارِيُو
ماسكيتو	Maschito	مَاسْكِيتُو
ماسكودا	Muscoda	مَاسْكُودَا
قعاني	Qaani	قَعَانِي
ماسوفيل	Massueville	مَاسُوفِيل
ماتاموروس	Matamoros	مَاتَامُورُوس
ماتيسون	Matteson	مَاتِيسُون
براييليف	Brailiv	بْرَايِيلِيف
ماورديان	Mavardian	مَاوَرْدِيَان
قفين	Qaffin	قَفِّين
قلاطية	Qalatiyah	قَلَاطِيَّة
كيونغجي	Qiongjie	كِيوُنْغْجِي
مبيكا	Mpika	مَبِيكَا
مداوروش	M'Daourouch	مَدَاوُرُوش
كاليغولا	Caligula	كَالِيغُولَا
كادنبآخ	Kadenbach	كَادِنْبَآخ
معبد	Mabad	مَعْبَد
شنأيتآخ	Schnaittach	شْنَأْيِتْآخ
معمولان	Mamulan	مَعْمُولَان
قرغن	Qorghan	قُرْغَن
كواسكيوتن	Quasqueton	كُوَاسْكِيُوتْن
كاربنتر	Carpenter	كَارْبِنْتِر
مفشق	Mafshaq	مَفْشَق
مغانجيق	Moghanjiq	مُغَانْجِيق
اكتسينس	Aktisanes	أَكْتِسِينِس
سيرايلوس	Cerrillos	سِيرَايِلُوس
رواضي	Rouadi	رُوَاضِي
مغنية	Maghnia	مَغْنِيَة
محبوب	Mahbub	مَحْبُوب
مهويد	Mahvid	مَهْوِيد
كيركوول	Kirkwall	كِيرْكْوُول
روحي	Ruhi	رَوْحِيّ
كلينتون	Clinton	كْلِينْتُون
ريسي	Rysy	رِيسِي
سانوا	Sannois	سَانْوَا
مكانتس	McCants	مَكَانْتْس
سانتيلي	Santelli	سَانْتِيلِّي
هوكتمبر	Sardarapat	هُوكْتِمْبِر
مكينون	McKinnon	مَكِينُون
مكلور	McClure	مَكْلُور
صفاك	Seffak	صِفَّاك
كيوريبتو	Curepto	كِيُورِيبْتُو
شربة	Serpa	شِرْبَة
الدهماني	Dahmani	دَهْمَانِيّ
مليحان	Malihan	مَلِيحَان
سيرامانا	Serramanna	سِيرَّامَانَّا
سيدلر	Seyyedlar	سَيِّدْلَر
شيفر	Shafer	شَيْفَر
شاكمبهري	Shakambhari	شَاكَمْبْهَرِي
مندانك	Mandanak	مَنْدَانَك
ديفايزيس	Devizes	دِيفَايْزِيس
الجباحية	Djebahia	جِبَاحِيَّة
شلواري	Shalvari	شَلْوَارِي
شميرانات	Shemiran	شِمِيرَانَات
مقدرة	Makedra	مَقِدْرَة
مقطع	Maqta	مَقْطَع
دوديلانج	Dudelange	دُودِيلَانْج
ايبولوا	Ebolowa	إِيبُولُوَا
إدواردس	Edwards	إِدْوَارْدْس
مقطع	Section	مَقْطَع
إكلاتوم	Ekallatum	إِكَلَاتُوم
إلكمونت	Elkmont	إِلْكْمُونْت
شيورين	Shivarin	شِيوَرِين
إركيللا	Ercilla	إِرْكِيلْلَا
شريفبورت	Shreveport	شْرِيفِبُورْت
شوشاندخت	Shushandukht	شُوشَانْدُخْت
سيليلي	Silili	سِيلِيلِي
مسلول	Maslul	مَسْلُول
يستيلنك	Estelnic	يْسْتِيلْنِك
مثكا	Mathkā	مَثْكَا
مورم	Mawram	مَوْرَم
بلاطة	Slab	بَلَاطَة
سلولي	Soluli	سُلُولِي
شوبرون	Sopron	شُوبْرُون
الفرقاني	Fergani	فِرْقَانِيّ
فيرمون	Fermont	فِيرْمُون
ميروبا	Mayrouba	مَيْرُوبَا
ميسن	Mysen	مَيْسِن
فولرتون	Fowlerton	فَوْلَرْتُون
مابلتون	Mapleton	مَابِلْتُون
ميسور	Mysore	مَيْسُور
سوفيتشيلي	Sovicille	سُوفِيتْشِيلِّي
تايني	Tainy	تَايْنِي
ميجيليتو	Miguelito	مِيجِيلِيتُو
غيسورن	Geisshorn	غِيسُورْن
ميكروكار	Microcar	مِيكْرُوكَار
ميلانيزيا	Melanesia	مِيلَانِيزِيَا
ميلاندري	Melandri	مِيلَانْدْرِي
ميليرفيل	Millerville	مِيلِيرْفِيل
ميلفيل	Melville	مِيلْفِيل
ميلفيل	Millville	مِيلْفِيل
توبري	Towbori	تَوْبُرِي
تريبي	Tripi	تْرِيبِي
ميناسا	MENASA	مِينَاسَا
مينتكيتش	Meenetkech	مِينِتْكِيتْش
مينياكا	Meñaka	مِينِيَاكَا
مينيسوتا	Minnesota	مِينِيسُوتَا
مينجورا	Mingora	مِينْجُورَا
مينوكوا	Minocqua	مِينُوكْوَا
هاستون	Halston	هَاسْتُون
مزيك	Mazik	مَزِيك
مزداران	Mazdaran	مَزْدَارَان
مشكات	Meshkat	مِشْكَات
مينونك	Minonk	مِينُونْك
مينورو	Minoru	مِينُورُو
مندوزا	Mendoza	مِنْدُوزَا
إغناثيو	Ignacio	إِغْنَاثِيُو
منساه	Mensah	مِنْسَاه
ميشار	Mišar	مِيشَار
ميشيلا	Michaela	مِيشِيلَا
مياكي	Miyake	مِيَاكِي
مياكي	Miyaki	مِيَاكِي
ميدلاندز	Midlands	مِيدْلَانْدْز
ميهوب	Mihoub	مِيهُوب
ميجندي	Mejandi	مِيجَنْدِي
توغبري	Tugabri	تُوغَبْرِي
ميكا	Mica	مِيكَا
ميكا	Mika	مِيكَا
ميكا	Myca	مِيكَا
ميرندا	Mirinda	مِيرِنْدَا
ميرين	Meereen	مِيرِين
ميرين	Meyrin	مِيرِين
ميرون	Meiron	مِيرُون
ميسن	Mesen	مِيسِن
ميسن	Mission	مِيسِن
كرغلين	Kargalin	كَرْغَلِين
ميسور	Missour	مِيسُور
كاسيغلوك	Kasigluk	كَاسِيغْلُوك
أواكيت	Uakit	أُوَاكِيت
كيتيلمير	Ketelmeer	كِيتِيلْمِير
ميلروز	Melrose	مِيلْرُوز
خركوية	Kharguiyeh	خَرْكُوِيَّة
ميلتاون	Milltown	مِيلْتَاوْن
ميلتونا	Miltona	مِيلْتُونَا
أويدا	Ueda	أُوِيدَا
ميزيا	Mesía	مِيزْيَا
أوغاريت	Ugarit	أُوغَارِيت
أوغاريت	UGARIT	أُوغَارِيت
أونالاكليت	Unalakleet	أُونَالَاكْلِيت
مينر	Miner	مِينَر
الهراويين	Lahraouyine	هْرَاوِيِّين
مينر	Minner	مِينَر
ممتاز	Mumtaz	مُمْتَاز
مرسية	Murcia	مُرْسِيَة
أونيتشا	Unecha	أُونِيتْشَا
موشاتيشت	Mușătești	مُوشَاتِيشْت
بارسينت	Parcent	بَارْسِينْت
مينتز	Mentz	مِينْتْز
مينتز	Mintz	مِينْتْز
أوجهورود	Uzhhorod	أُوجْهُورُود
مواكشا	Moacșa	مُوَاكْشَا
فاجليا	Vaglia	فَاجْلِيَا
فايتابي	Vaitape	فَايْتَابِي
ليبينثال	Liebenthal	لِيبِينْثَال
موغلان	Muglan	مُوغْلَان
ليتينهيم	Littenheim	لِيتِينْهَيِم
موكاوا	Mukawa	مُوكَاوَا
فلاديمورو	Valdemoro	فَلَادِيمُورُو
سلايتون	Slayton	سْلَايْتُون
مولتاتولي	Multatuli	مُولْتَاتُولِي
لوجيمو	Longjumeau	لُوجِيمُو
فالنزا	Valenza	فَالِنْزَا
ستانتون	Stanton	سْتَانْتُون
ميتاكس	Metakse	مِيتَاكْس
ميتيور	Meteor	مِيتِيُور
فالينهوس	Valinhos	فَالِينْهُوس
ميزة	Meeza	مِيزَة
فالندار	Vallendar	فَالِنْدَار
سوتونغا	Sottunga	سُوتُّونْغَا
مشابي	Mishabi	مِشَابِي
مشرفة	Mosharafa	مُشَرَفَة
مشرفة	Al-Musharifah	مُشَرِفَة
مشرفة	Mushrifah	مُشْرِفَة
مبتعة	Mibta'ah	مِبْتَعَة
فاليتا	Valletta	فَالِيتَا
محرر	Muharrir	مُحَرِّر
فاليثود	Vallithode	فَالِيثُود
مَتُزِنيُش	Matosinhos	مَتُزِنْيُش
مورانو	Murano	مُورَانُو
موراتا	Morata	مُورَاتَا
موراتا	Murata	مُورَاتَا
مقرب	Moqarrab	مُقَرَّب
مقرب	Muqarrab	مُقَرَّب
مرسي	Morsi	مُرْسِي
فالوغنس	Valognes	فَالُوغْنِس
فامبيتا	Vampeta	فَامْبِيتَا
مورسفيل	Mooresville	مُورْسْفِيل
متريت	Mitrit	مِتْرِيت
موريجاق	Murichaq	مُورِيجَاق
فاندويغ	Vandeweghe	فَانْدُويْغ
موريتس	Móricz	مُورِيتْس
فانغانل	Vanganel	فَانْغَانِل
امزفرون	Mzefroune	إِمْزِفْرُون
ثيوبالد	Theobald	ثِيُوبَالْد
فانغودي	Vangudi	فَانْغُودِي
موسو	Mosso	مُوسُو
موسوليني	Mussolini	مُوسُولِينِي
موزاية	Mouzaïa	مُوزَايَة
فانيه	Vanier	فَانِيِه
نامون	Namwon	نَامُون
فاندل	Vanndale	فَانْدَل
ناريف	Narew	نَارِيف
فانسفيل	Vansville	فَانْسْفِيل
ناروساوا	Narusawa	نَارُوسَاوَا
ناتالي	Natalie	نَاتَالِي
ناتالي	Nathalie	نَاتَالِي
ناتشوريزا	Natureza	نَاتْشُورِيزَا
ناتورنز	Naturns	نَاتُورْنْز
فانزي	Vanzay	فَانْزَي
أوريسكا	Oriska	أُورِيسْكَا
مورستان	Murestan	مُورِسْتَان
مورستان	Muristan	مُورِسْتَان
نايسفيل	Niceville	نَايْسْفِيل
فانزي	Vanzy	فَانْزِي
اوفرتون	Overton	أُوفَرْتُون
فيرفوريله	Vârfurile	فِيرْفُورِيلِه
ناريسكيون	Varisci	نَارِيسْكِيُون
نقيعة	Naqi'a	نَقِيعَة
بيكوليار	Peculiar	بِيكُولِيَار
مورفين	Morven	مُورْفِين
مورتيمر	Mortimer	مُورْتِيمَر
نتكاماني	Natakamani	نَتَكَامَانِي
موسى	Moses	مُوسَى
موسى	Mousa	مُوسَى
موسى	Moussa	مُوسَى
موسى	Musa	مُوسَى
فاروني	Varuni	فَارُونِي
موسير	Mosier	مُوسِير
فاتوتيني	Vatutine	فَاتُوتِينِي
نيجلن	Nijlen	نَيْجِلِن
نظرلو	Nazarlu	نَظَرْلُو
فيهايوكي	Pyhäjoki	فِيهَايُوكِي
نفتكامسك	Neftekamsk	نِفْتِكَامْسْك
فيرغاس	Vergas	فِيرْغَاس
كوادريل	Quadrelle	كُوَادْرِيل
الرحباني	Rahbani	رَحْبَانِيّ
ناشوريتا	Naturita	نَاشُورِيتَا
نابارنيز	Nabarniz	نَابَارْنِيز
نابس	Naps	نَابْس
نادان	Nadan	نَادَان
نافاسوتا	Navasota	نَافَاسُوتَا
نافنيت	Navneet	نَافْنِيت
نافساري	Navsari	نَافْسَارِي
ناغاشو	Naghachu	نَاغَاشُو
رينغيلاي	Ringelai	رِينْغِيلَاي
ناكس	Knucks	نَاكْس
رنشون	Ronchamp	رُنْشُون
نياسر	Niasar	نِيَاسَر
نيكوتشيا	Necochea	نِيكُوتْشِيَا
فيرغينا	Vergina	فِيرْغِينَا
فيرولي	Veroli	فِيرُولِي
نارك	Närke	نَارْك
نارسون	Narsun	نَارْسُون
نينيوس	Nennius	نِينْيُوس
نينورتا	Ninurta	نِينُورْتَا
نيتيدال	Nittedal	نِيتِيدَال
نغيرولمود	Ngerulmud	نْغِيرُولْمُود
نيانرونغ	Nyainrong	نْيَانْرُونْغ
الشيباني	Shaibani	شَيْبَانِيّ
فياماو	Viamão	فِيَامَاو
نواوة	Nuaveh	نُوَاوَة
نوبوهيرو	Nobuhiro	نُوبُوهِيرُو
سلبتون	Slapton	سْلَبْتُون
نوبوتاكا	Nobutaka	نُوبُوتَاكَا
نايتو	Naito	نَايْتُو
نايتو	Naitō	نَايْتُو
نبيهة	Safwa	نَبِيهَة
نوفاتك	Novatek	نُوفَاتِك
نفطال	Naftal	نَفْطَال
نهار	Nahar	نَهَار
نوندي	Noonday	نُونْدِي
بينديجون	Bendejun	بِينْدِيجُون
شترايش	Streich	شْتْرَايِش
نورهس	Nurhaci	نُورْهَس
نهلة	Nahla	نَهْلَة
نمين	Namin	نَمِين
نورتشا	Norcia	نُورْتْشَا
نورويتش	Norwich	نُورْوِيتْش
نوسن	Nossen	نُوسِن
نوتاريسكو	Notaresco	نُوتَارِيسْكُو
نوتشوان	Nuchavan	نُوتْشَوَان
قانصوه	Kansu	قَانْصُوه
قاقالو	Qaqalu	قَاقَالُو
قباطية	Qabatiya	قَبَاطِيَة
قدمكاه	Qadamgah	قَدَمْكَاه
فياني	Vianney	فِيَانِّي
فيكرز	Vickers	فَيْكَرْز
نيشيتا	Nechita	نِيشِيتَا
فياراسا	Villarrasa	فِيَارَاسَا
نيبا	Neba	نِيبَا
نيبلي	Nibley	نِيبْلِي
نيفادا	Nevada	نِيفَادَا
فانكلف	Vancleve	فَانْكْلِف
نيغاك	Neguac	نِيغَاك
نيغران	Nigrán	نِيغْرَان
نيكولس	Nichols	نِيكُولْس
قنا	Canna	قَنَّا
نيلس	Nils	نِيلْس
نيلو	Neelo	نِيلُو
قنطيت	Qantayt	قَنْطَيْت
قراتورة	Qaratureh	قَرَاتُورَة
قريس	Qeris	قِرِيس
قريضة	Qurayuah	قُرَيْضَة
فيلنوف	Villeneuve	فِيلِنُوف
نيوبي	Niobe	نِيُوبِي
نيوبطليموس	Neoptolemus	نِيُوبْطْلَيْمُوس
شينيانج	Xinyang	شِينِيَانْج
نيوفيلد	Newfield	نِيُوفِيلْد
نيوغا	Neoga	نِيُوغَا
اليوسفية	Youssoufia	يُوسُفِيَّة
اليوسفية	Yusufiyah	يُوسُفِيَّة
نيولا	Neola	نِيُولَا
قرومة	Guerrouma	قِرُومَة
قونوقوس	Gunugus	قُونُوقُوس
قورقنيا	Qurqania	قُورْقَنِيَا
بيرفآيلر	Bärweiler	بِيرْفَآيْلَر
قورصو	Corso	قُورْصُو
قوسار	Qusar	قُوسَار
قوتورلار	Quturlar	قُوتُورْلَار
راهوفتسي	Rahovtsi	رَاهُوفْتْسِي
راجوفارن	Raghuvaran	رَاجُوفَارَن
بيساجويرو	Pesaguero	بِيسَاجُوِيرُو
رامهرمز	Ramhormoz	رَامْهُرْمُز
رينولد	Reinhold	رَيْنُولْد
ركريو	Recreo	رِكْرِيُو
رنشن	Renchen	رِنْشِن
آندرناخ	Andernach	آنْدَرْنَاخ
رنغات	Rengat	رِنْغَات
انغلتون	Angleton	أَنْغِلْتُون
ريانتشو	Rianxo	رِيَانْتْشُو
رياردو	Riardo	رِيَارْدُو
براموكسي	Bramucci	بْرَامُوكْسِي
ارزوئيه	Arzuiyeh	أَرْزُوئِيِه
أتايجينا	Ataegina	أَتَايْجِينَا
ريدينغ	Reading	رِيدِينْغ
أتينهوفن	Attenhofen	أَتِينْهُوفِن
آورآختآل	Aurachtal	آوَرَآخْتَال
برينتوود	Brentwood	بْرِينْتْوُود
ريدفورد	Redford	رِيدْفُورْد
ريدجولو	Reggiolo	رِيدْجُولُو
ريدلر	Riddler	رِيدْلَر
قاقون	Qaqun	قَاقُون
قاطورة	Qatura	قَاطُورَة
ريفانتا	Revanta	رِيفَانْتَا
البيسارية	Bissariyeh	بِيسَّارِيَّة
ريفرغروف	Rivergrove	رِيفَرْغْرُوف
ريفيسفيل	Rivesville	رِيفِيسْفِيل
ريجيفورسل	Rijkevorsel	رِيجِيفُورْسِل
دافلويفيل	Daveluyville	دَافْلُويِفِيل
قهرود	Qohrud	قَهْرُود
ريكاردو	Ricardo	رِيكَارْدُو
ريكاردو	Riccardo	رِيكَارْدُو
ريمبلاس	Rimplas	رِيمْبْلَاس
قراقرم	Karakoram	قَرَاقُرَم
رينيبو	Rennebu	رِينِيبُو
رينغل	Ringle	رِينْغِل
قطان	Kattan	قَطَّان
كاستركوم	Castricum	كَاسْتْرِكُوم
قطان	Qotan	قُطَان
قفيص	Qufays	قُفَيْص
رينتيريا	Errenteria	رِينْتِيرِيَا
قريضة	Cistus	قُرَيْضَة
ريساكا	Resaca	رِيسَاكَا
فيليرز	Villiers	فِيلِيرْز
شويفينيرغ	Chöpfenberg	شُويِفِينْيِرْغ
تسيخانوف	Ciechanów	تِسِيخَانُوف
سيكونتنير	Cinquantenaire	سِيكُونْتْنِير
ريتافاس	Rietavas	رِيتَافَاس
ريانو	Reano	رِيَانُو
رميش	Rmaich	رْمَيْش
دمداباجا	Damdabaja	دَمْدَابَاجَا
فيرتال	Virtaal	فِيرْتَال
روايت	Roiate	رُوَايَت
روبيه	Roubaix	رُوبِيه
روبيكوني	Rubicon	رُوبِيكُونِي
رَشيد	Rashid	رَشِيد
راشيل	Rachel	رَاشِيل
رادكان	Radkan	رَادْكَان
رادنوفاس	Radnovac	رَادْنُوفَاس
رادو	Rado	رَادُو
روبليدو	Robledo	رُوبْلِيدُو
رودني	Rodney	رُودْنِي
فيسكونتي	Visconti	فِيسْكُونْتِي
راميتان	Romitan	رَامِيتَان
روينا	Rowena	رُوِينَا
رانبورن	Ranburne	رَانْبُورْن
جيفرسون	Geferson	جِيفِرْسُون
راندبورغ	Randburg	رَانْدْبُورْغ
راثبون	Rathbun	رَاثْبُون
غوودريتش	Goodrich	غُووُدْرِيتْش
راونج	Ravanj	رَاوَنْج
رايلاند	Rayland	رَايْلَانْد
رحالة	Planula	رَحَّالَة
رحالة	Rahhala	رَحَّالَة
رجعانة	Raj'anah	رَجْعَانَة
رمسيس	Ramesses	رَمْسِيس
رمسيس	Ramses	رَمْسِيس
روات	Rawat	رَوَات
رينز	Raines	رَيِنْز
ريدان	Raydān	رَيْدَان
ريمة	Raymah	رَيْمَة
روجينا	Rogena	رُوجِينَا
هيربرت	Heribert	هِيرِبِرْت
رزقة	Raziqah	رَزِقَة
حصارتشة	Hesarcheh	حِصَارْتْشَة
هيليورن	Hillehorn	هِيلِيُورْن
هيندسفيل	Hindsville	هِينْدْسْفِيل
هينيغاران	Hinigaran	هِينِيغَارَان
روكيسكيس	Rokiškis	رُوكِيسْكِيس
آيسلستاين	IJsselstein	آيْسِلْسْتَايِن
روماغنيس	Romagnese	رُومَاغْنِيس
رومينفيل	Romainville	رُومَيْنْفِيل
روات	Riwat	رِوَات
ايتاسكا	Itasca	إِيتَاسْكَا
روندا	Rhonda	رُونْدَا
روندا	Ronda	رُونْدَا
روسيندال	Roosendaal	رُوسِينْدَال
روسليبن	Roßleben	رُوسْلِيبِن
روتوراس	Roturas	رُوتُورَاس
روثرهام	Rotherham	رُوثَرْهَام
لآنغنتآل	Langenthal	لَآنْغْنِتآل
ساباوديا	Sabaudia	سَابَاوْدِيَا
سابيجنيس	Sapignies	سَابِيجْنِيس
سابينوف	Sabinov	سَابِينُوف
ريفير	Revere	رِيفِير
سادها	Sadha	سَادْهَا
سافوسافو	Savusavu	سَافُوسَافُو
كيتادايتو	Kitadaitō	كِيتَادَايْتُو
ريهام	Reham	رِيهَام
ساجت	Sauget	سَاجِت
كورستين	Korosten	كُورُسْتِين
ساليسفيل	Salesville	سَالِيسْفِيل
سامامبايا	Samambaia	سَامَامْبَايَا
ريمة	Rima	رِيمَة
فولبيلينو	Volpeglino	فُولْبِيلِينُو
سانيكيلي	Sanniquellie	سَانِيكِيلِي
ماكليلان	McClellan	مَاكْلِيلَان
فربلياني	Vrbljani	فَرْبْلْيَانِي
سارالانج	Saralanj	سَارَالَانْج
مازاتلان	Mazatlán	مَازَاتْلَان
سارانسك	Saransk	سَارَانْسْك
ساسنيس	Cisnes	سَاسْنِيس
ساواغوتشي	Sawaguchi	سَاوَاغُوتْشِي
سايفينسي	Syvänsi	سَايْفِينَسِي
صبارا	Sabará	صَبَارَا
سعير	Sa'ir	سَعِير
فاتسواف	Wacław	فَاتْسُوَاف
سغريك	Segrik	سِغْرِيك
موريفيلد	Moorefield	مُورِيفِيلْد
سمسلو	Samselu	سَمْسِلُو
سموعة	SamU'ah	سَمُوعَة
نصيرآباد	Nasirabad	نَصِيرَآبَاد
سموحة	Semoha	سِمُوحَة
سنتوريا	Centuria	سِنْتُورِيَا
صراصر	Sirasir	صِرَاصِر
سراوك	Saravak	سَرَاوَك
ميدرايفيل	Medaryville	مِيدَرَايِفِيل
ميلمايزل	Mehlmeisel	مِيلْمَايْزِل
سراوق	Sarawak	سَرَاوَق
سرايان	Sarayan	سَرَايَان
سرقسطة	Caesaraugusta	سَرَقُسْطَة
روكيكي	Rokicki	رُوكِيكِي
سرقسطة	Sarakusta	سَرَقُسْطَة
سرقسطة	Saraqusta	سَرَقُسْطَة
موندوجار	Mondújar	مُونْدُوجَار
سرقسطة	Zaragoza	سَرَقُسْطَة
كابيثويلا	Cabizuela	كَابِيثُويِلَا
المرناقية	Mornaguia	مُرْنَاقِيَة
المليحية	Mouilha	مُلَيْحِيَّة
سردينيا	Sardinia	سَرْدِينْيَا
سرقسطة	Cesaracosta	سَرَقُسْطَة
موسكاتاين	Muscatine	مُوسْكَاتَايْن
سخينوسا	Schoinoussa	سْخِينُوسَا
فاجنهاوزن	Wagenhausen	فَاجِنْهَاوْزِن
سعرد	Siirt	سِعِرْد
سغجا	Segezha	سِغِجَا
سكيوتا	Sciota	سْكِيُوتَا
سليسل	Silaysil	سِلَيْسِل
سلوفينيا	Slovenia	سْلُوفِينِيَا
صماخ	Smakh	صْمَاخ
سمندس	Smendes	سْمِنْدِس
سنغافورة	Singapore	سِنْغَافُورَة
سركسيان	Sargsyan	سَرْكْسْيَان
ساكاكيبارا	Sakakibara	سَاكَاكِيبَارَا
اونكوتان	Onekotan	أُونِكُوتَان
سالاي	Salai	سَالَاي
سالاي	Salaì	سَالَاي
كاربونيل	Carbonell	كَارْبُونِيل
صالح	Saleh	صَالِح
صالح	Salih	صَالِح
سنترتون	Centerton	سِنْتَرْتُون
سالتفيك	Saltvik	سَالْتْفِيك
سالونا	Salona	سَالُونَا
سنتريكا	Centrica	سِنْتْرِيكَا
ساموث	Samoth	سَامُوث
سيداليا	Sedalia	سِيدَالْيَا
سيدك	SDEK	سْيْدِك
سانداو	Sandau	سَانْدَاو
ساندرا	Sandra	سَانْدْرَا
سيدلس	Siedlce	سِيدْلْس
سيسيلتون	Cecilton	سِيسِيلْتُون
سيفالون	Cephalon	سِيفَالُون
قاضيزاده	Qazizadeh	قَاضِيزَادِه
ساركوسي	Sarcoxie	سَارْكُوسِي
سارتكة	Sartakeh	سَارْتَكَة
سيهيونغ	Siheung	سِيهِيُونْغ
رارانتشيو	Radancheto	رَارَانْتْشِيُو
سيلارد	Szilárd	سِيلَارْد
سيليدوفي	Selydove	سِيلِيدُوفِي
فاليزيلن	Wallisellen	فَالِيزِيلِن
كوفينغتون	Covington	كُوفِينْغْتُون
ريكسينغين	Rexingen	رِيكْسِينْغِين
سيليوس	Silius	سِيلِيُوس
سيلفان	Silvan	سِيلْفَان
سيلفان	Sylvan	سِيلْفَان
سلهب	Salhab	سَلْهَب
سلمى	Salma	سَلْمَى
سلمى	Selma	سَلْمَى
سيماكسيس	Simaxis	سِيمَاكْسِيس
سيمكان	Simakan	سِيمَكَان
تاكلوبان	Tacloban	تَاكْلُوبَان
صندانس	Sundance	صَنْدَانْس
صنعاء	San'a	صَنْعَاء
صنعاء	Sana	صَنْعَاء
صنعاء	Sanaa	صَنْعَاء
سيمينارا	Seminara	سِيمِينَارَا
سقبا	Saqba	سَقْبَا
سيمزبورت	Simmesport	سِيمِزْبُورْت
سيمكا	Simca	سِيمْكَا
سكوينشين	Schoenchen	سْكُويِنْشِين
سيناي	Sinai	سِينَاي
سينيفيل	Senneville	سِينِيفِيل
سينيرشيا	Senerchia	سِينِيرْشِيَا
ليبديان	Lebedyan	لِيبِدِيَان
فاسينورن	Wasenhorn	فَاسِينْوُرْن
سيراس	Cyrus	سَيْرَاس
سيركو	Sercu	سِيرْكُو
تورتومان	Tortoman	تُورْتُومَان
سبراغينز	Spraggins	سْبْرَاغِينْز
سيرتك	CertiK	سِيرْتِك
سيرون	Serón	سِيرُون
ستيرنهيل	Sternhell	سْتِيرْنْهِيل
سيسينيوس	Sisinnius	سِيسِينِيُوس
وليكآباد	Valikabad	وَلِيكَآبَاد
سيستينو	Sestino	سِيسْتِينُو
سينابو	Seynabou	سَيْنَابُو
سيسونغ	Zhezhung	سِيسُونْغ
سيتارد	Sittard	سِيتَارْد
سيتشنارو	Secinaro	سِيتْشِنَارُو
سيوير	Sivir	سِيوِير
سيزانو	Sizzano	سِيزَانُو
إينغلوود	Inglewood	إِينْغِلْوُود
سيزمور	Sizemore	سَيْزْمُور
تيرايفو	Teryayevo	تِيرَايْفُو
سبرلينغا	Sperlinga	سْبِرْلِينْغَا
سبرينغز	Springs	سْبْرِينْغْز
سكالداسول	Scaldasole	سْكَالْدَاسُول
سكولنيك	Skolnick	سْكُولْنِيك
أوردولايز	Urduliz	أُورْدُولَايْز
سسطلان	Sestelan	سِسْطِلَان
فالجيو	Valgioie	فَالْجِيُو
سكورديا	Scordia	سْكُورْدِيَا
سكوتبريدج	Stockbridge	سْكُوتْبْرِيدْج
سكوتفيل	Scottsville	سْكُوتْفِيل
سكوتفيل	Scottville	سْكُوتْفِيل
سميمو	Smimou	سْمِيمُو
مووربارك	Moorpark	مُووُرْبَارْك
سميتشوف	Smíchov	سْمِيتْشُوف
سموليانا	Smoljana	سْمُولْيَانَا
سريتنسك	Sretensk	سْرِيتِنْسْك
ستابهورست	Staphorst	سْتَابْهُورْسْت
وينغرو	Wingrave	وِينْغْرُو
ستابليس	Staples	سْتَابْلِيس
ستامب	Stamp	سْتَامْب
زافيتنيي	Zavetnyy	زَافِيتْنِيِي
شاوبينغ	Zhaoping	شَاوْبِينْغ
ستارسات	StarSat	سْتَارْسَات
سيلغرد	Silgerd	سِيلْغِرْد
ستاخانوف	Kadiivka	سْتَاخَانُوف
ستيكني	Stickney	سْتِيكْنِي
ستيتشني	Stickney	سْتِيتْشْنِي
ستوات	Stolat	سْتُوَات
ستوري	Storey	سْتُورِي
اجرثينوت	Ajarthinut	أَجَرْثِينُوت
ستوي	Stoy	سْتُوي
باييزآباد	Paizabad	بَايِيزْآبَاد
برآيتنآو	Breitenau	بْرَآيْتِنَآو
سينجتل	SingTel	سِينْجْتِل
سخيربنزيل	Scherpenzeel	سْخِيرْبِنْزِيل
انانتابور	Ananthapuram	أَنَانْتَابُور
صفينة	Sufaynah	صُفَيْنَة
أرانديغا	Arándiga	أَرَانْدِيغَا
أراندايلا	Arandilla	أَرَانْدَايْلَا
صهيب	Suhayb	صُهَيْب
سكوداي	Skudai	سُكُودَاي
رآوبلينغ	Raubling	رَآوْبْلِينْغ
آتالانتا	Atalanta	آتَالَانْتَا
سليمان	Soliman	سُلَيْمَان
سليمان	Solomon	سُلَيْمَان
سليمان	Souleymane	سُلَيْمَان
بارسلونا	Barcelona	بَارْسِلُونَا
براكستون	Braxton	بْرَاكْسْتُون
بيفيرفايك	Beverwijk	بِيفِيرْفَايْك
بريدجمان	Bridgman	بْرِيدْجْمَان
بلومبرغ	Blomberg	بْلُومْبِرْغ
سليمان	Sulaiman	سُلَيْمَان
سليمان	Suleiman	سُلَيْمَان
سليمان	Sulejman	سُلَيْمَان
فتسلار	Wetzlar	فِتْسْلَار
ريدووتر	Redwater	رِيدْوُوُتَر
صنيحات	Sahinat	صُنَيْحَات
سوارترانس	Swartkrans	سُوَارْتْرَانْس
سوبات	Subate	سُوبَات
بورغنيتش	Burgnich	بُورْغْنِيتْش
سوبرماما	SuperMama	سُوبَرْمَامَا
سوبرانتسى	Sobrance	سُوبْرَانْتْسَى
سوبول	Supaul	سُوبُول
بورتونوود	Burtonwood	بُورْتُونْوُود
سمنونيون	Semnones	سَمْنُونِيّ
قنطبرية	Cantabria	قَنْطَبْرِيَة
فليبرورد	Willibrord	فِلِيبْرُورْد
سوهاوا	Sohawa	سُوهَاوَا
سوهتال	Suhtal	سُوهْتَال
سويدا	Soeda	سُوِيدَا
سوكنة	Sokna	سُوكْنَة
قلمرية	Coimbra	قُلُمْرِيَة
سولاناس	Solanas	سُولَانَاس
سولينا	Sulina	سُولِينَا
سشريكورن	Schreckhorn	سْشْرِيكُورْن
سوليو	Saulieu	سَوْلِيُو
سولتشافا	Solčava	سُولْتْشَافَا
سبرينكلر	Sprinklr	سْبْرِينْكْلْر
سولتسي	Soltsy	سُولْتْسِي
سوليو	Soglio	سُولْيُو
سولولا	Sololá	سُولُولَا
الجيبوتيون	Djiboutians	جِيبُوتِيّ
سوميت	Summit	سُومِيت
سوراو	Surav	سُورَاو
سورك	Surak	سُورَك
سوريك	Surik	سُورِيك
سوريسو	Soriso	سُورِيسُو
إنفيغادو	Envigado	إِنْفِيغَادُو
ايرين	Ernestine	إِيرِين
سوربو	Surbo	سُورْبُو
سوركنفري	Sorgenfri	سُورْكِنْفْرِي
فرناندس	Fernandes	فِرْنَانْدِس
سوسارت	Susart	سُوسَارْت
غونغتشان	Gongchan	غُونْغْتْشَان
سوسورلوك	Susurluk	سُوسُورْلُوك
سوتك	Sotk	سُوتْك
سوتومو	Sutomo	سُوتُومُو
جابرييل	Gabriella	جَابْرِييِل
صُخَيرة	Zuera	صُخَيْرَة
طشانة	Tocina	طُشَانَة
تشمنلو	Chamanlu	تْشَمَنْلُو
هيوفلتون	Heuvelton	هِيُوفِلْتُون
غليناردين	Glenarden	غْلِينَارْدِين
سليمان	Slimane	سْلَيْمَان
هوانغشان	Huangshan	هُوَانْغْشَان
تشرباس	Cherbas	تْشِرْبَاس
جوندريزيك	Gondrezick	جُونْدْرِيزِيك
هوليستون	Holliston	هُولِيِسْتُون
غروسلوايد	Gorslwyd	غُرُوسْلْوَايْد
تاشودة	Tachouda	تَاشُودَة
جرينهالغ	Greenhalgh	جْرِينْهَالْغ
هوستونيا	Houstonia	هُوسْتُونِيَا
تاباتا	Tabata	تَابَاتَا
جيمستاون	Jamestown	جِيمِسْتَاوْن
جيوجيانغ	Jiujiang	جْيُوجْيَانْغ
تابو	Taboo	تَابُو
تابو	Tabu	تَابُو
جورجتاون	Georgetown	جُورْجْتَاوْن
تابوتي	Tapputi	تَابُوتِي
تاغانروغ	Taganrog	تَاغَانْرُوغ
تاجيا	Tegea	تَاجِيَا
كيداباوان	Kidapawan	كِيدَابَاوَان
كينغسوود	Kingswood	كِينْغْسْوُود
هوندسروغ	Hundsrügg	هُونْدْسْرُوغ
هاتشينسون	Hutchinson	هَاتْشِينْسُون
تاجورة	Tadjoura	تَاجُورَة
الإيبيريون	Iberians	إِيبِيرِيّ
تاكاياما	Takayama	تَاكَايَامَا
تاكيشي	Takeshi	تَاكِيشِي
انفينيتي	Infiniti	إِنْفِينِيتِي
تاكيتورا	Taketora	تَاكِيتُورَا
تاكنا	Tacna	تَاكْنَا
ايتريدو	Ittireddu	إِيتِّرِيدُّو
تاكزيرت	Taghzirt	تَاكْزِيرْت
تاليسكا	Talisca	تَالِيسْكَا
خارايكيخو	Jaraicejo	خَارَايْكِيخُو
تامامورا	Tamamura	تَامَامُورَا
كارنتشيتا	Karencitta	كَارِنْتْشِيتَا
تاميه	Tamia	تَامِيَه
كازنلاك	Kazanlak	كَازَنْلَاك
تاميلا	Tammela	تَامِّيلَا
تامدة	Tamda	تَامْدَة
تاناكا	Tanaka	تَانَاكَا
تانغوي	Tanguy	تَانْغُوي
تانوما	Tanuma	تَانُومَا
تارائوسا	Tarauacá	تَارَائُوسَا
تاراكا	Taraka	تَارَاكَا
تارهوفو	Tarhovo	تَارْهُوفُو
تاركان	Tarkan	تَارْكَان
فيلتن	Wilthen	فِيلْتِن
تايوا	Taiwa	تَايْوَا
ميلدتاون	Middletown	مِيلْدْتَاوْن
سوسة	Al-Susah	سُوسَة
تازاغين	Tazaghine	تَازَاغِين
مانسايلاس	Manciles	مَانْسَايْلَاس
تازوطة	Tazouta	تَازُوطَة
تبردا	Teberda	تِبِرْدَا
تفرش	Tafresh	تَفْرِش
تغلب	Taghlib	تَغْلِب
تحميد	Tahmid	تَحْمِيد
تكتيك	Tactic	تَكْتِيك
قلقلآباد	Qolqolabad	قُلْقُلَآبَاد
تلمين	Telmine	تِلْمِين
تلوكدار	Talukder	تَلُوكْدَار
طرابلس	Tripoli	طَرَابُلُس
ميتشايانا	Michiana	مِيتْشَايَانَا
تراتالياس	Tratalias	تْرَاتَالِيَاس
فوتسوافك	Włocławek	فُوتْسْوَافِك
محمديه	Mohammadiyeh	مُحَمَّدِيَّه
ترينيداد	Trinidad	تْرِينِيدَاد
ترباج	Tërbaç	تِرْبَاج
طرسوس	Tarsus	طَرْسُوس
نافارينكس	Navarrenx	نَافَارِينْكْس
نايانتارا	Nayanthara	نَايَانْتَارَا
طرطوس	Tartus	طَرْطُوس
نديجيميبر	Nedjemibre	نِدِيجِيمِيبْر
نوربرتو	Norberto	نُورْبِرْتُو
طروادة	Troy	طِرْوَادَة
تسلطانت	Tassoultante	تَسُلْطَانْت
طباع	Tabaa	طَبَاع
تلاوي	Telavi	تِلَاوِي
تنوفا	Tnuva	تْنُوفَا
تربسن	Trebsen	تْرِبْسِن
تريبي	Trebbi	تْرِيبِّي
ترينيدادي	Trinidadians	تْرِينِيدَادِيّ
تسقي	Tisqi	تِسْقِي
تتورث	Tetworth	تِتْوُرْث
تونوكوتيه	Tonocoté	تُونُوكُوتِيه
سيفبيروم	Cefpirome	سِيفْبِيرُوم
تيدمرش	Tidmarsh	تِيدْمَرْش
ويلنغتون	Wellington	وِيلِنْغْتُون
تيغيسي	Teguise	تِيغِيسِي
وودبريدج	Woodbridge	وُودْبْرِيدْج
وودبريدج	Woodridge	وُودْبْرِيدْج
ووردفاست	Wordfast	وُورْدْفَاسْت
تيغيستي	Tegueste	تِيغِيسْتِي
تيهيشا	Teahitia	تِيهِيشَا
تيحنيس	Tihnays	تِيحْنَيْس
راتسهبورغ	Ratzeburg	رَاتْسْهِبُورْغ
ريكيندورف	Reckendorf	رِيكِينْدُورْف
تيكريكرة	Tigrigra	تِيكْرِيكْرَة
تيليسيلا	Telesilla	تِيلِيسِيلَا
تيلبورخ	Tilburg	تِيلْبُورْخ
شلوبينية	Salobreña	شَلُوبِينِيَة
ساولتشوي	Saulchoy	سَاوُلْتْشُوي
ساوتسكي	Sawitzki	سَاوِتْسْكِي
سايالونغا	Sayalonga	سَايَالُونْغَا
تيميشوارا	Timișoara	تِيمِيشُوَارَا
ستوريفيل	Storyville	سْتُورِيفِيل
تيمياوين	Timiaouine	تِيمِيَاوِين
تيميمون	Timimoun	تِيمِيمُون
تينغتشو	Tengzhou	تِينْغْتْشُو
تيرانس	Terrance	تِيرَانْس
تيرير	Terrer	تِيرِير
تيرناو	Thyrnau	تِيرْنَاو
تيرول	Tyrol	تِيرُول
تيتوشكي	Titushky	تِيتُوشْكِي
تشرتقلو	Cherteqlu	تْشِرْتِقْلُو
تشيدستر	Chidester	تْشِيدِسْتَر
سينلاباخوس	Sinlabajos	سِينْلَابَاخُوس
شيوتورب	Sjuntorp	شْيُوتُورْب
تشولاقلو	Chowlaqlu	تْشُولَاقْلُو
بيافيرتون	Beaverton	بِيَافِيرْتُون
ترجينتس	Třinec	تْرْجِينِتْس
تروفاريلو	Trofarello	تْرُوفَارِيلُّو
وانكويتن	Wanquetin	وَانْكُويِتِن
فولينسكي	Wolinski	فُولِينْسْكِي
شيدي	Xidi	شِيدِي
تولنتينو	Tolentino	تُولِنْتِينُو
برتزفيلد	Pretzfeld	بْرِتْزْفِيلْد
توموت	Tommot	تُومُّوت
تسارادي	Tsaradia	تْسَارَادِي
بودينغتون	Boddington	بُودِينْغْتُون
فرشاغن	Vereshchagin	فِرِشَاغِن
تورسباي	Thorsby	تُورْسْبَاي
تورية	Torreya	تُورِيَة
تورية	Touria	تُورِيَة
توريبرونا	Torrebruna	تُورِّيبْرُونَا
توريفايجا	Torrevieja	تُورِّيفَايْجَا
توريغروتا	Torregrotta	تُورِّيغْرُوتَّا
تورشم	Teversham	تِوِرْشَم
ولنبيرغ	Wollenberg	وُلِنْبِيرْغ
تورتل	Turtle	تُورْتِل
تتا	Tita	تِتَا
توسولا	Tuusula	تُوسُولَا
توتانا	Totana	تُوتَانَا
تويوكا	Toyooka	تُويُوكَا
ثيان	Cillán	ثِيَّان
ثيبوكا	Thibiuca	ثِيبُوكَا
ثيغاما	Zegama	ثِيغَامَا
ثيتفورد	Thetford	ثِيتْفُورْد
أدلينغتون	Adlington	أَدْلِينْغْتُون
ألبونيانو	Albugnano	أَلْبُونْيَانُو
وابيلباج	Wapelbach	وَابِيلْبَاج
وادقان	Vadeqan	وَادِقَان
واكاندا	Wakanda	وَاكَانْدَا
واكاروسا	Wakarusa	وَاكَارُوسَا
وانجانوي	Whanganui	وَانْجَانُوي
وارومبونغل	Warrumbungles	وَارُومْبُونْغْل
واوكي	Waukee	وَاوْكِي
وايام	Whigham	وَايَام
وايلوكو	Wailuku	وَايْلُوكُو
وهالان	Whalan	وَهَالَان
شينغنينغ	Xingning	شِينْغْنِينْغ
تشابين	Chapin	تْشَابِين
تشابين	Chaplin	تْشَابِين
تشابهار	Chabahar	تْشَابْهَار
تشابليغين	Chaplygin	تْشَابْلِيغِين
تشانكيا	Chanakya	تْشَانَكْيَا
تشاوتون	Chawton	تْشَاوْتُون
تشغالو	Cheghalu	تْشَغَالُو
تشمبان	Champan	تْشَمْبَان
تشناقتشي	Chenaqchi	تْشِنَاقْتْشِي
كروسبيتون	Crosbyton	كْرُوسْبِيتُون
ورنكش	Varnakesh	وَرْنَكِش
تشيغاب	Chighab	تْشِيغَاب
كورتيلاثور	Cortelazor	كُورْتِيلَاثُور
تشيما	Chema	تْشِيمَا
تشينغوان	Chengguan	تْشِينْغُوَان
وسقونقان	Vesquneqan	وِسْقُونِقَان
تشيسترفيلد	Chesterfield	تْشِيسْتِرْفِيلْد
ديمييفتسي	Dimievtsi	دِيمِييِفْتْسِي
تشيتشستر	Chichester	تْشِيتْشِسْتَر
إبيرفينغ	Eberfing	إِبِيرْفِينْغ
تشوغود	Ciugud	تْشُوغُود
فتحالله	Fathullah	فَتْحَالْلَّه
ويافرلي	Waverly	وَيَافِرْلِي
وزويا	Lozoya	وَزُويَا
فوردينهيم	Furdenheim	فُورْدِينْهَيِم
ترامب	Trump	تْرَامْب
تريكازي	Tricase	تْرِيكَازِي
وشلنهوسن	Wichlinghausen	وِشْلِنْهَوْسِن
ويدوج	Viduj	وِيدُوج
تشرام	Choram	تُشْرَام
ويلينغدون	Willingdon	وِيلِينْغْدُون
انترفلوج	Interflug	إِنْتَرْفْلُوج
ويليس	Willis	وِيلِيس
طرناي	Tournai	طُرْنَاي
توارن	Tuwarin	تُوَارِن
توايس	Twice	تُوَايْس
طوباش	Topbaş	طُوبَاش
ليوواردن	Leeuwarden	لِيُووَارْدِن
كامرشتاين	Kammerstein	كَامَرْشْتَايْن
توبين	Tobin	تُوبِين
لوتينبورغ	Lütjenburg	لُوتِينْبُورْغ
كيرتشهيم	Kirchheim	كِيرْتْشْهَيِم
توكماك	Tokmak	تُوكْمَاك
كوستولاني	Kosztolányi	كُوسْتُولَانِي
توكموك	Tokmok	تُوكْمُوك
ويلكنسون	Wilkinson	وِيلْكِنْسُون
لاوتاساري	Lauttasaari	لَاوْتَاسَارِي
توميكا	Tomika	تُومِيكَا
تومين	Tumen	تُومِين
تومين	Tumin	تُومِين
تومبول	Tomball	تُومْبُول
ليدويغان	Lledwigan	لِيدْوِيغَان
طومسون	Thompson	طُومْسُون
طومسون	Thomson	طُومْسُون
ويلكيسفيل	Wilkesville	وِيلْكِيسْفِيل
توموت	Tumut	تُومُوت
ميلرزويو	Millersview	مِيلِرْزْوِيُو
ويلكوس	Wilcox	وِيلْكُوس
توقاد	Tokat	تُوقَاد
توران	Turan	تُورَان
وينيباغو	Winnebago	وِينِيبَاغُو
ناسيمنتو	Nascimento	نَاسِيمِنْتُو
ويندوفر	Wendover	وِينْدُوفَر
وينكونن	Winneconne	وِينْكُونْن
ويرسولل	Wirswall	وِيرْسُولْل
ويسكوت	Wescott	وِيسْكُوت
اوليانيكو	Oglianico	أُولْيَانِيكُو
بالافروغي	Palafrugell	بَالَافْرُوغِي
ويسنير	Wisner	وِيسْنِير
ويزنر	Wiesner	وِيزْنَر
يتوندون	Yattendon	يَتُونْدُون
بيناجوايلا	Penàguila	بِينَاجُوَايْلَا
خالدأباد	Khaledabad	خَالِدْأَبَاد
خالصان	Khalesan	خَالِصَان
خانقاه	Khaneqah	خَانِقَاه
بوبونديتا	Popondetta	بُوبُونْدِيتَا
خانيوال	Khanewal	خَانِيوَال
سنترتاون	Centertown	سِنْتَرْتَاوْن
خارنغان	Kharengan	خَارِنْغَان
خاصبيك	Khasbek	خَاصْبِيك
خاتمة	Khatimah	خَاتِمَة
خدافر	Khidafir	خِدَافِر
خفرع	Khafra	خَفْرَع
خلوات	Khalouat	خَلَوَات
زكية	Zakia	زَكِيَّة
خربوشة	Kharboucha	خَرْبُوشَة
سولبيات	Sulbiate	سُولْبِيَات
خرنابات	Kingirban	خَرْنَابَات
ختشيرة	Khachireh	خَتْشِيرَة
خزندار	Khaznadar	خَزْنَدَار
خيميالكون	Gimialcón	خِيمِيَالْكُون
خشتيانك	Kheshtianak	خِشْتِيَانَك
خجندة	Khujand	خُجَنْدَة
خميني	Khomeini	خُمَيْنِي
وبل	Wibil	وِبِل
فاسيليفكا	Vasylivka	فَاسِيلِيفْكَا
فيرخوفاجي	Verkhovazhye	فِيرْخُوفَاجِي
فيزينجارم	Vizianagaram	فِيزِيَنَجَارَم
خراشاد	Khorashad	خُرَاشَاد
خريم	Khiraym	خِرَيْم
خروسلو	Khoruslu	خُرُوسْلُو
خويمة	Khuwaymah	خُوَيْمَة
يونغتشينغ	Yongcheng	يُونْغْتْشِينْغ
خونان	Hunan	خُوْنَان
خوتيابا	Jutiapa	خُوتِيَابَا
الشرنبلالي	Al-Shurunbulali	شُرُنْبُلَالِيّ
أنستاسافين	Anastasavan	أَنَسْتَاسَافِين
شيانغيانغ	Xiangyang	شِيَانْغْيَانْغ
يابوكي	Yabuki	يَابُوكِي
يادغارلو	Yadegarlu	يَادِغَارْلُو
ياموتشي	Yamauchi	يَامَوْتْشِي
باهرايتش	Bahraich	بَاهْرَايْتْش
بانكوفتسي	Bankovtsi	بَانْكُوفْتْسِي
يانادا	Yanada	يَانَادَا
يانيش	Janić	يَانِيش
يانداو	Yandao	يَانْدَاو
يارمن	Jarmen	يَارْمِن
بوروينيتشة	Borovinići	بُورُويِنِيتْشَة
ياصيد	Yasid	يَاصِيد
بورغنلاند	Burgenland	بُورْغِنْلَانْد
ياسمين	Jasmin	يَاسْمِين
ياسمين	Jasmine	يَاسْمِين
دراييفتسي	Dragievtsi	دْرَايِيفْتْسِي
ياسمين	Jasminum	يَاسْمِين
ياسمين	Yasmin	يَاسْمِين
ياوتسو	Yaotsu	يَاوْتْسُو
يحشوش	Yahchouch	يَحْشُوش
دورنبرغر	Dornberger	دُورْنْبِرْغَر
يهوشافاط	Jehoshaphat	يَهُوشَافَاط
يلكلو	Yalaklu	يَلَكْلُو
ايكوميديا	Eco-Médias	إِيكُومِيدْيَا
إنتربرايز	Enterprise	إِنْتِرْبْرَايْز
هاغرستاون	Hagerstown	هَاغَرْسْتَاوْن
يلملم	Yalamlam	يَلَمْلَم
فلكسورث	Folksworth	فُلْكْسْوُرْث
هوششتنبآخ	Höchstenbach	هُوشِشْتِنْبَآخ
يمتلاند	Jämtland	يَمْتْلَانْد
يستري	Eastrea	يَسْتِرِي
هاوتسنبرغ	Hauzenberg	هَاوْتْسِنْبِرْغ
هيركيولانوم	Herculaneum	هِيرْكِيُولَانُوم
زيفيري	Zefyri	زِيفِيرِي
هيسبانيولا	Hispaniola	هَيْسْبَانِيُولَا
كابانكالان	Kabankalan	كَابَانْكَالَان
يزرعيل	Jezreel	يَزْرَعِيل
اتانهانجا	Itanhangá	إِتَانْهَانْجَا
يلماز	Yılmaz	يِلْمَاز
يوغرطة	Jugurtha	يُوغُرْطَة
يولكينو	Yolkino	يُولْكِينُو
يوريكراتس	Eurycrates	يُورِيكْرَاتِس
كانكابولي	Kānekapōlei	كَانِكَابُولِي
يورتيجي	Urtijëi	يُورْتِيجِي
يوسدال	Ljusdal	يُوسْدَال
يوتربوغ	Jüterbog	يُوتَرْبُوغ
مارلينهيم	Marlenheim	مَارْلِينْهَيِم
زاهية	Zahia	زَاهِيَة
امبراكايو	Mbaracayú	إِمْبْرَاكَايُو
ميراندايلا	Mirandilla	مِيرَانْدَايِلَا
زاندام	Zaandam	زَانْدَام
زانكي	Zanki	زَانْكِي
مونتسنبرغ	Münzenberg	مُونْتْسِنْبِرْغ
زاركو	Zarko	زَارْكُو
بارشاتار	Parshatatar	بَارْشَاتَار
زاستافنا	Zastavna	زَاسْتَافْنَا
سيلفرستون	Silverstone	سِيلْفَرْسْتُون
زاوديرزي	Zuiderzee	زَاوِدِيرْزِي
زازران	Zazeran	زَازِرَان
روديلينهيم	Rodelinghem	رُودِيلِينْهِيم
زبولون	Zebulun	زِبُولُون
زعفرانبول	Safranbolu	زَعْفَرَانْبُول
زكية	Zekiye	زَكِيَّة
جاجوكة	Zhazhukeh	جَاجُوكَة
زكريت	Zakrit	زَكْرِيت
تشونغيوان	Zhongyuan	تْشُونْغِيُوَان
سيلنيارفي	Siilinjärvi	سِيلِنْيَارْفِي
زليران	Zaliran	زَلِيرَان
وودسبرينغ	Woodspring	وُودْسْبْرِينْغ
زالدنبورغ	Saldenburg	زَالْدِنْبُورْغ
زنغلانلو	Zangelanlu	زَنْغِلَانْلُو
أرمسترونغ	Armstrong	أَرْمْسْتْرُونْغ
أوقيانوسيا	Oceania	أُوقِيَانُوسِيَا
السليمانية	Sulaymaniyah	سُلَيْمَانِيَّة
سوستينورن	Sustenhorn	سُوسْتِينْوُرْن
آشوربانيبال	Ashurbanipal	آشُورْبَانِيبَال
تونغانوكسي	Tonganoxie	تُونْغَانُوكْسِي
شاتوبريانت	Châteaubriant	شَاتُوبْرِيَانْت
شيفينوجليا	Schivenoglia	شِيفِينُوجْلْيَا
تورومتيكول	Turumtaykul	تُورُومْتَيْكُول
شيندازيونث	Chindasuinth	شِينْدَازِيُونْث
بيتيجليانو	Pitigliano	بِيتِيجْلِيَانُو
بلومينغديل	Bloomingdale	بْلُومِينْغْدِيل
بورتالبيرا	Portalbera	بُورْتَالْبِيرَا
فايشنفلد	Waischenfeld	فَايْشِنْفِلْد
فيتيلسهوفين	Wittelshofen	فِيتِيلْسْهُوفِين
بوسينتريفت	Bösentrift	بُوسِينْتْرِيفْت
دراونيرفين	Drouwenerveen	دْرَاوْنِيرْفِين
فاندونكورت	Vandoncourt	فَانْدُونْكُورْت
فنزويليون	Venezuelans	فِنِزْوِيلِيّ
فيلافرويلا	Villafruela	فِيلَافْرُويِلَا
فيرتبورفين	Verteporfin	فِيرْتِبُورْفِين
أنطونيتا	Antonietta	أَنْطُونِيِتَّا
فولتشانيتس	Volchanets	فُولْتْشَانِيتْس
فونيلانديا	Funilândia	فُونِيلَانْدِيَا
بارافرانكا	Barrafranca	بَارَّافْرَانْكَا
فورستينزيل	Fürstenzell	فُورْسْتِينْزِيل
غارفانيانا	Garfagnana	غَارْفَانِيَانَا
غراتشانيكا	Gracanica	غْرَاتْشَانِيكَا
كاسالانغيدا	Casalanguida	كَاسَالَانْغِيدَا
غروسهولبآخ	Großholbach	غْرُوسْهُولْبَآخ
هيرتيزفيلد	Hertzfeld	هِيرْتِيزْفِيلْد
يلب	Yelp	يِلْب
هولانسبورغ	Hollansburg	هُولَانْسْبُورْغ
كاونتريسايد	Countryside	كَاوْنْتْرِيسَايْد
كيوراريهيو	Curarrehue	كِيُورَارْيِهْيُو
ديسبوتوفاتس	Despotovac	دِيسْبُوتُوفَاتْس
دارماكرتي	Dharmakirti	دَارْمَاكِرْتِي
زنكانٌ	Karabayır	زَنْكَان
دونتزينهيم	Duntzenheim	دُونْتْزِينْهَيِم
زنقوفة	Zanqufa	زَنْقُوفَة
زرادشت	Zoroaster	زَرَادَشْت
كركياويات	Grues	كَرْكِيَاوِيَّات
زراوة	Zraoua	زْرَاوَة
زردوغان	Zardughan	زَرْدُوغَان
زليتوفو	Zletovo	زْلِيتُوفُو
جيفكوف	Zhivkov	جِيفْكُوف
لوكسوفلوكس	Luxoflux	لُوكْسُوفْلُوكْس
لوتزيلهواس	Lutzelhouse	لُوتْزِيلْهُوَاس
زيندا	Zenda	زِينْدَا
ميللينغتون	Millington	مِيلْلِينْغْتُون
مونكالييري	Moncalieri	مُونْكَالْيِيرِي
إمغاتوزوماب	Imgatuzumab	إِمْغَاتُوزُومَاب
نوفودفينسك	Novodvinsk	نُوفُودْفِينْسْك
سينليسكيوس	Senlecques	سِينْلِيسْكِيُوس
ستاتزيرورن	Stätzerhorn	سْتَاتْزِيرُورْن
سودليرسفيل	Sudlersville	سُودْلِيرْسْفِيل
سورنوجيرفي	Surnujärvi	سُورْنُوجِيرْفِي
تاكواريمبو	Tacuarembó	تَاكُوَارِيمْبُو
تشيريليانو	Cirigliano	تِشِيرِيلِيَانُو
ترنغاينرغ	Tregynrig	تِرِنْغَايْنِرْغ
ترينيتاليا	Trenitalia	تِرِينِيتَالْيَا
تركمانيون	Turkmenistanis	تُرْكُمَانِيّ
توريبيروخيل	Torreperogil	تُورِيبِيرُوخِيل
مونتيموريلوس	Montemorelos	مُونْتِيمُورِيلُوس
نافاكونسيخو	Navaconcejo	نَافَاكُونْسِيخُو
زيريان	Zirian	زِيرِيَان
نيديرفولبآخ	Niederfüllbach	نِيدِيرْفُولْبَآخ
خريفيلينجن	Grevelingen	خْرِيفِيلِينْجِن
يواخيمستال	Joachimsthal	يُوَاخِيمْسْتَال
زنفتنبيرغ	Senftenberg	زِنْفْتِنْبِيرْغ
زيريانوفسك	Altai	زِيرْيَانُوفِسْك
باركيسيميتو	Barquisimeto	بَارْكِيسِيمِيتُو
دهارماتاكور	Dharmathakur	دْهَارْمَاتَاكُور
فآيلبينغرت	Feilbingert	فَآيِلْبِينُغِرْت
فارماكونيسي	Farmakonisi	فَارْمَاكُونِيسِي
ستورناريلا	Stornarella	سْتُورْنَارِيلَّا
فاساليلياغا	Fa'asaleleaga	فَاسَالِيلِيَاغَا
فونتانابران	Fontanabran	فُونْتَانَابْرَان
زرزير	Zarzir	زَرْزِير
تيوفيلانديا	Teofilândia	تِيُوفِيلَانْدِيَا
زبولون	Zebulon	زِبُولُون
زبونة	ZibUnah	زِبُونَة
جانكورتاران	Cankurtaran	جَانْكُورْتَارَان
تريسباديرني	Trespaderne	تْرِيسْبَادِيرْنِي
زندن	Senden	زِنْدِن
فالديليناريس	Valdelinares	فَالْدِيلِينَارِيس
جيوباترونيم	Géopatronyme	جِيوُبَاتْرُونِيم
فانيمكولم	Vaniyamkulam	فَانِيمْكُولْم
كامبونوغارا	Camponogara	كَامْبُونُوغَارَا
كاستلانيتا	Castellaneta	كَاسْتِلَّانِيتَا
زيكيم	Zikim	زِيكِيم
تشيرنوفتسي	Chernivtsi	تْشِيرْنُوفْتْسِي
زينسو	Zinsou	زِينْسُو
تركمانباشي	Türkmenbaşy	تُرْكُمَانْبَاشِي
زيبنغبيرغه	Siebengebirge	زِيبِنْغِبِيرْغِه
زيستابوني	Zestaponi	زِيسْتَابُونِي
زفيجنتس	Zwierzyniec	زْفِيِجِنْتْس
زفينيغورود	Zvenigorod	زْفِينِيغُورُود
زهانغبينغ	Zhangping	زْهَانْغْبِينْغ
زبيدة	Zübeyde	زُبَيْدَة
كلينتشوبورت	Clinchport	كْلِينْتْشُوبُورْت
زكيكة	Zukaykah	زُكَيْكَة
زوفيان	Zofian	زُوفِيَان
إينشاكوشانا	Enshakushanna	إِينْشَاكُوشَانَّا
زوينجن	Zwingen	زُوِينْجِن
فالكنشتاين	Falkenstein	فَالْكِنْشْتَايْن
زَوْمَرَّاقة	Zumarraga	زُومَرَّاقَة
زومرلوخ	Sommerloch	زُومَرْلُوخ
زوندرن	Sundern	زُونْدَرْن
زوسيموس	Zosimus	زُوسِيمُوس
غوادالاخارا	Guadalajara	غُوَادَالَاخَارَا
هارسكيرتسن	Harskirchen	هَارْسْكِيرْتْسِن
هولوفانيفسك	Holovanivsk	هُولُوفَانِيفْسْك
لامبيرثيم	Lampertheim	لَامْبِيرْثَيِم
لاورنستاون	Lawrencetown	لَاوْرِنْسْتَاوْن
لاوندسبورو	Lowndesboro	لَاوْنْدِسْبُورُو
ماهاجانابادا	Mahajanapada	مَاهَاجَانَابَادَا
مارينترافيك	MarineTraffic	مَارِينْتْرَافِيك
مونتيفلافيو	Monteflavio	مُونْتِيفْلَافِيُو
نوفوبولوتسك	Navapolack	نُوفُوبُولُوتْسْك
أورانينبورغ	Oranienburg	أُورَانِينْبُورْغ
بلايسكيرشن	Pleiskirchen	بْلَايْسْكِيرْشِن
برودانوفتسي	Prodanovtsi	بْرُودَانُوفْتْسِي
ساندنشان	Sandnessjøen	سَانْدِنْشَان
شيتشيكاشوكو	Shichikashuku	شِيتْشِيكَاشُوكُو
زوست	Soest	زُوسْت
تورتيفونتين	Tortefontaine	تُورْتِيفُونْتِين
زوتبانسيرغ	Zoutpansberg	زُوتْبَانْسِيرْغ
فاندويغ	Vandewegheara	فَانْدُوِيغ
فيلابلاريكس	Vilablareix	فِيلَابْلَارِيكْس
زينالروثورن	Zinalrothorn	زِينَالْرُوثُورْن
أرويومولاينوس	Arroyomolinos	أَرُّويُومُولَايْنُوس
أوغستينبيرغ	Augstenberg	أُوغَسْتِينْبِيرْغ
أوغستماتورن	Augstmatthorn	أُوغَسْتْمَاتُورْن
بلوبرهاوسيز	Blubberhouses	بْلُوبَرْهَاوْسِيز
كاستروريالي	Castroreale	كَاسْتْرُورِيَالِي
تشارليفويكس	Charlevoix	تْشَارْلِيفُويِكْس
كريستيانية	Christiania	كْرِيسْتِيَانِيَة
دروسكينينكي	Druskininkai	دْرُوسْكِينِينْكَي
إكرومكسيماب	Ecromeximab	إِكْرُومِكْسِيمَاب
غسبالتينورن	Gspaltenhorn	غْسْبَالْتِينُورْن
هايليغنهافن	Heiligenhafen	هَايْلِيغِنْهَافِن
لينكولنشاير	Lincolnshire	لِينْكُولِنْشَايَر
لودفيغسشتات	Ludwigsstadt	لُودْفِيغْسْشْتَات
موتساغرونيا	Mozzagrogna	مُوتْسَاغْرُونْيَا
مونيوغراندي	Muñogrande	مُونِيُوغْرَانْدِي
ناكاساتسوناي	Nakasatsunai	نَاكَاسَاتْسُونَاي
أوبرشينفيلد	Oberscheinfeld	أُوبِرْشَيْنْفِيلْد
باسكوالكوبو	Pascualcobo	بَاسْكُوَالْكُوبُو
بولبطرسبرغ	Paulpietersburg	بُولْبِطِرِسْبُرْغ
بوخفيستنيفو	Pokhvistnevo	بُوخْفِيسْتْنِيفُو
سودرمانلاند	Södermanland	سُودَرْمَانْلَانْد
سبيلامبيرتو	Spilamberto	سْبِيلَامْبِيرْتُو
شتروليندورف	Strullendorf	شْتْرُولِينْدُورْف
سيكشفهيرفار	Székesfehérvár	سِيكَشْفْهِيرْفَار
أوليانوبوليس	Ulianópolis	أُولِيَانُوبُولِيس
فلاديبيلاجوس	Valdepiélagos	فَلَادِيبِيلَاجُوس
فاندزيوغالا	Vandžiogala	فَانْدْزِيُوغَالَا
فرملزكيرشن	Wermelskirchen	فِرْمِلْزْكِيرْشِن
ويليامسفيلد	Williamsfield	وِيلِيَامَسْفِيلْد
باغايفسكايا	Bagayevskaya	بَاغَايِفْسْكَايَا
بورغولافيزارو	Borgolavezzaro	بُورْغُولَافِيزَارُو
تشيلدرسبورغ	Childersburg	تْشِيلْدِرْسْبُورْغ
فوردونجيانوس	Fordongianus	فُورْدُونْجِيَانُوس
فرونتينهاوزن	Frontenhausen	فْرُونْتِينْهَاوْزِن
هرتسوغشتاند	Herzogstand	هِرْتْسُوغْشْتَانْد
مونسترلينغن	Münsterlingen	مُونْسْتَرْلِينْغِن
نافاتالغوردو	Navatalgordo	نَافَاتَالْغُورْدُو
توناكاكيهواتل	Tonacacihuatl	تُونَاكَاكِيهُوَاتْل
تروختلفينغن	Trochtelfingen	تْرُوخْتِلْفِينْغِن
فانتشينكولام	Vanchiyankulam	فَانْتْشِيَنْكُولَام
فستريوتلاند	Västergötland	فَسْتَرِيُوتْلَانْد
فورونيجسكايا	Voronezhskaya	فُورُونِيجِسْكَايَا
زيلينوبورسكي	Zelenoborsky	زِيلِينُوبُورْسْكِي
زولوتاريوفكا	Zolotaryovka	زُولُوتَارْيُوفْكَا
باكينغهامشير	Buckinghamshire	بَاكِينْغْهَامْشَيَر
تشيليلابومبوي	Chililabombwe	تْشِيلِيلَابُومْبُوي
سفيروبايكالسك	Severobaykalsk	سِفِيرُوبَايْكَالْسْك
كواتزاكوالكوس	Coatzacoalcos	كُوَاتْزَاكُوَالْكُوس
ثرومبوبلاستين	F3	ثْرُومْبُوبْلَاسْتِين
كيتاناكاغوسوكو	Kitanakagusuku	كِيتَانَاكَاغُوسُوكُو
كراسنوزافودسك	Krasnozavodsk	كْرَاسْنُوزَافُودْسْك
أوبرسولتزباتش	Obersoultzbach	أُوبِرْسُولْتْزْبَاتْش
كراسنوفايشرسك	Krasnovishersk	كْرَاسْنُوفَايِشِرْسْك
مونتيكاستريلي	Montecastrilli	مُونْتِيكَاسْتْرِيلِّي
ورستلينغورته	Wrestlingworth	وْرِسْتْلِينْغْوُرْتَه
غلوكوناستورتيان	Gluconasturtiin	غْلُوكُونَاسْتُورْتِيَان
هانغيندغليتشيرورن	Hangendgletscherhorn	هَانْغِينْدْغْلِيتْشِيرُورْن
جودبراندسدالسلوجين	Gudbrandsdalslågen	جُودْبْرَانْدْسْدَالْسْلُوجِين